,,,,,,,Account,Type,,Date,,Num,,Name,,Memo,,Class,,Clr,,Split,,Debit,,Credit,,Balance
,,,,6010 · Advertising & Marketing,,,,,,,,,,,,,,,,,,,,,,,,
,,,,,,,6010 Advertising & Marketing,Check,,01/02/2019,,,,FACEBOOK,,,,,,,,1200 · Checking BOA 6959 MG,,60.19,,,,60.19
,,,,,,,6010 Advertising & Marketing,Check,,01/02/2019,,,,FACEBOOK,,,,,,,,1200 · Checking BOA 6959 MG,,25.27,,,,85.46
,,,,,,,6010 Advertising & Marketing,General Journal,,01/11/2019,,4,,,,Home Depot,,,,,,2500 · N/P-  Joshua Smith,,7.21,,,,92.67
,,,,,,,6010 Advertising & Marketing,Check,,01/11/2019,,,,ADOBE,,,,,,,,1200 · Checking BOA 6959 MG,,9.99,,,,102.66
,,,,,,,6010 Advertising & Marketing,Check,,01/14/2019,,,,ADOBE,,,,,,,,1200 · Checking BOA 6959 MG,,52.99,,,,155.65
,,,,,,,6010 Advertising & Marketing,Check,,01/14/2019,,,,GO DADDY,,,,,,,,1200 · Checking BOA 6959 MG,,24.34,,,,179.99
,,,,,,,6010 Advertising & Marketing,Check,,01/15/2019,,,,GO DADDY,,,,,,,,1200 · Checking BOA 6959 MG,,8.47,,,,188.46
,,,,,,,6010 Advertising & Marketing,Check,,01/15/2019,,,,GO DADDY,,,,,,,,1200 · Checking BOA 6959 MG,,42.35,,,,230.81
,,,,,,,6010 Advertising & Marketing,Check,,01/17/2019,,,,MONTROY,,vinyl banner,,,,,,1000 · Checking BOA 2589,,75.14,,,,305.95
,,,,,,,6010 Advertising & Marketing,Check,,01/18/2019,,,,GO DADDY,,,,,,,,1200 · Checking BOA 6959 MG,,11.17,,,,317.12
,,,,,,,6010 Advertising & Marketing,Check,,01/18/2019,,,,Wix.Com,,,,,,,,1200 · Checking BOA 6959 MG,,36.00,,,,353.12
,,,,,,,6010 Advertising & Marketing,Deposit,,01/23/2019,,,,MONTROY,,,,,,,,1000 · Checking BOA 2589,,,,75.14,,277.98
,,,,,,,6010 Advertising & Marketing,Check,,01/23/2019,,,,GO DADDY,,,,,,,,1200 · Checking BOA 6959 MG,,62.99,,,,340.97
,,,,,,,6010 Advertising & Marketing,Check,,01/28/2019,,,,Wix.Com,,,,,,,,1200 · Checking BOA 6959 MG,,4.95,,,,345.92
,,,,,,,6010 Advertising & Marketing,Check,,02/01/2019,,,,FACEBOOK,,,,,,,,1000 · Checking BOA 2589,,100.73,,,,446.65
,,,,,,,6010 Advertising & Marketing,Check,,02/04/2019,,,,GO DADDY,,,,,,,,1200 · Checking BOA 6959 MG,,35.99,,,,482.64
,,,,,,,6010 Advertising & Marketing,Check,,02/12/2019,,,,Wix.Com,,,,,,,,1000 · Checking BOA 2589,,156.00,,,,638.64
,,,,,,,6010 Advertising & Marketing,Check,,02/13/2019,,,,ADOBE,,,,,,,,1200 · Checking BOA 6959 MG,,52.99,,,,691.63
,,,,,,,6010 Advertising & Marketing,Check,,02/13/2019,,,,ADOBE,,,,,,,,1200 · Checking BOA 6959 MG,,9.99,,,,701.62
,,,,,,,6010 Advertising & Marketing,Check,,02/19/2019,,,,Wix.Com,,,,,,,,1200 · Checking BOA 6959 MG,,36.00,,,,737.62
,,,,,,,6010 Advertising & Marketing,Check,,03/01/2019,,,,Wix.Com,,,,,,,,1200 · Checking BOA 6959 MG,,4.95,,,,742.57
,,,,,,,6010 Advertising & Marketing,Check,,03/04/2019,,,,GO DADDY,,,,,,,,1200 · Checking BOA 6959 MG,,143.96,,,,886.53
,,,,,,,6010 Advertising & Marketing,Check,,03/05/2019,,,,AUTO Air & Vacuum,,W NY         03/04,,,,,,1010 · Chase 9063 -720,,1.50,,,,888.03
,,,,,,,6010 Advertising & Marketing,Check,,03/08/2019,,,,Lockett Inc,,Reno Home & Garden Show,,,,,,1000 · Checking BOA 2589,,"1,070.00",,,,"1,958.03"
,,,,,,,6010 Advertising & Marketing,Check,,03/11/2019,,,,Wix.Com,,,,,,,,1000 · Checking BOA 2589,,14.50,,,,"1,972.53"
,,,,,,,6010 Advertising & Marketing,Check,,03/11/2019,,,,ADOBE,,,,,,,,1200 · Checking BOA 6959 MG,,9.99,,,,"1,982.52"
,,,,,,,6010 Advertising & Marketing,Check,,03/13/2019,,,,ADOBE,,,,,,,,1200 · Checking BOA 6959 MG,,52.99,,,,"2,035.51"
,,,,,,,6010 Advertising & Marketing,Check,,03/14/2019,,1302,,HOME DEPOT,,green carpet for home show,,,,,,1010 · Chase 9063 -720,,25.30,,,,"2,060.81"
,,,,,,,6010 Advertising & Marketing,Check,,03/21/2019,,,,Wix.Com,,,,,,,,1200 · Checking BOA 6959 MG,,36.00,,,,"2,096.81"
,,,,,,,6010 Advertising & Marketing,Check,,03/25/2019,,,,Lockett Inc,,03/21,,,,,,1010 · Chase 9063 -720,,10.00,,,,"2,106.81"
,,,,,,,6010 Advertising & Marketing,Check,,03/28/2019,,,,GO DADDY,,,,,,,,1200 · Checking BOA 6959 MG,,8.47,,,,"2,115.28"
,,,,,,,6010 Advertising & Marketing,Check,,03/29/2019,,,,Wix.Com,,,,,,,,1200 · Checking BOA 6959 MG,,4.95,,,,"2,120.23"
,,,,,,,6010 Advertising & Marketing,Check,,03/29/2019,,,,GO DADDY,,,,,,,,1200 · Checking BOA 6959 MG,,12.17,,,,"2,132.40"
,,,,,,,6010 Advertising & Marketing,Check,,04/01/2019,,1284,,GO DADDY,,,,,,,,1200 · Checking BOA 6959 MG,,8.47,,,,"2,140.87"
,,,,,,,6010 Advertising & Marketing,Check,,04/01/2019,,1285,,GO DADDY,,,,,,,,1200 · Checking BOA 6959 MG,,8.47,,,,"2,149.34"
,,,,,,,6010 Advertising & Marketing,Check,,04/01/2019,,1286,,FACEBOOK,,,,,,,,1200 · Checking BOA 6959 MG,,36.00,,,,"2,185.34"
,,,,,,,6010 Advertising & Marketing,Check,,04/02/2019,,1287,,GO DADDY,,,,,,,,1200 · Checking BOA 6959 MG,,8.47,,,,"2,193.81"
,,,,,,,6010 Advertising & Marketing,General Journal,,04/05/2019,,sc,,,,Home Depot - flower/veg for moana gh,,,,,,2500 · N/P-  Joshua Smith,,57.06,,,,"2,250.87"
,,,,,,,6010 Advertising & Marketing,Check,,04/10/2019,,,,Wix.Com,,,,,,,,1000 · Checking BOA 2589,,14.50,,,,"2,265.37"
,,,,,,,6010 Advertising & Marketing,Check,,04/11/2019,,1289,,ADOBE,,,,,,,,1200 · Checking BOA 6959 MG,,9.99,,,,"2,275.36"
,,,,,,,6010 Advertising & Marketing,Check,,04/15/2019,,,,Fiverr.com,,04/12,,,,,,1010 · Chase 9063 -720,,7.00,,,,"2,282.36"
,,,,,,,6010 Advertising & Marketing,Check,,04/15/2019,,1291,,Creative Cloud,,,,,,,,1200 · Checking BOA 6959 MG,,52.99,,,,"2,335.35"
,,,,,,,6010 Advertising & Marketing,Check,,04/18/2019,,1294,,Wix.Com,,,,,,,,1200 · Checking BOA 6959 MG,,36.00,,,,"2,371.35"
,,,,,,,6010 Advertising & Marketing,Check,,04/22/2019,,,,CRAIGSLIST,,04/19,,,,,,1010 · Chase 9063 -720,,3.00,,,,"2,374.35"
,,,,,,,6010 Advertising & Marketing,Check,,04/22/2019,,,,CRAIGSLIST,,04/19,,,,,,1010 · Chase 9063 -720,,50.00,,,,"2,424.35"
,,,,,,,6010 Advertising & Marketing,General Journal,,04/27/2019,,10129,,,,Home Depot - Terra Cotta pots for Moana Demo Gh,,,,,,2500 · N/P-  Joshua Smith,,64.92,,,,"2,489.27"
,,,,,,,6010 Advertising & Marketing,General Journal,,04/28/2019,,,,,,Home Depot - drip system etc for moana gh,,,,,,2500 · N/P-  Joshua Smith,,91.93,,,,"2,581.20"
,,,,,,,6010 Advertising & Marketing,Check,,04/29/2019,,1297,,Wix.Com,,,,,,,,1200 · Checking BOA 6959 MG,,4.95,,,,"2,586.15"
,,,,,,,6010 Advertising & Marketing,Check,,05/06/2019,,,,DIRECT Fairways,,05/03,,,,,,1010 · Chase 9063 -720,,399.00,,,,"2,985.15"
,,,,,,,6010 Advertising & Marketing,Check,,05/07/2019,,,,DIRECT Fairways,,05/06,,,,,,1010 · Chase 9063 -720,,650.00,,,,"3,635.15"
,,,,,,,6010 Advertising & Marketing,Check,,05/08/2019,,,,GO DADDY,,05/07,,,,,,1010 · Chase 9063 -720,,205.36,,,,"3,840.51"
,,,,,,,6010 Advertising & Marketing,Check,,05/10/2019,,,,MOANA NURSERY,,05/10,,,,,,1010 · Chase 9063 -720,,252.26,,,,"4,092.77"
,,,,,,,6010 Advertising & Marketing,Check,,05/13/2019,,1304,,ADOBE,,,,,,,,1200 · Checking BOA 6959 MG,,9.99,,,,"4,102.76"
,,,,,,,6010 Advertising & Marketing,Check,,05/13/2019,,1306,,Creative Cloud,,,,,,,,1200 · Checking BOA 6959 MG,,52.99,,,,"4,155.75"
,,,,,,,6010 Advertising & Marketing,Check,,05/16/2019,,,,Wix.Com,,,,,,,,1000 · Checking BOA 2589,,14.50,,,,"4,170.25"
,,,,,,,6010 Advertising & Marketing,Check,,05/21/2019,,1259,,Nevada State Fair,,,,,,,,1010 · Chase 9063 -720,,780.00,,,,"4,950.25"
,,,,,,,6010 Advertising & Marketing,Check,,05/21/2019,,1309,,Wix.Com,,,,,,,,1200 · Checking BOA 6959 MG,,36.00,,,,"4,986.25"
,,,,,,,6010 Advertising & Marketing,General Journal,,05/21/2019,,10134,,,,CVS - hose & nozzle for Demo GH Moana,,,,,,2500 · N/P-  Joshua Smith,,29.21,,,,"5,015.46"
,,,,,,,6010 Advertising & Marketing,Check,,05/23/2019,,,,truckee home show,,CCD ID: 9215986202,,,,,,1010 · Chase 9063 -720,,495.00,,,,"5,510.46"
,,,,,,,6010 Advertising & Marketing,Check,,05/24/2019,,1311,,GO DADDY,,,,,,,,1200 · Checking BOA 6959 MG,,71.88,,,,"5,582.34"
,,,,,,,6010 Advertising & Marketing,Check,,05/28/2019,,1312,,Wix.Com,,,,,,,,1200 · Checking BOA 6959 MG,,4.95,,,,"5,587.29"
,,,,,,,6010 Advertising & Marketing,Check,,05/28/2019,,,,Nb Productions,,Memo:05/24,,,,,,1010 · Chase 9063 -720,,84.00,,,,"5,671.29"
,,,,,,,6010 Advertising & Marketing,Check,,06/10/2019,,,,Wix.Com,,,,,,,,1000 · Checking BOA 2589,,14.50,,,,"5,685.79"
,,,,,,,6010 Advertising & Marketing,Deposit,,06/11/2019,,,,Carson Home Show,,1,,,,,,1010 · Chase 9063 -720,,,,50.00,,"5,635.79"
,,,,,,,6010 Advertising & Marketing,Check,,06/19/2019,,,,Wix.Com,,06/17,,,,,,1010 · Chase 9063 -720,,36.00,,,,"5,671.79"
,,,,,,,6010 Advertising & Marketing,General Journal,,06/24/2019,,10124,,,,moana nursery,,,,,,2500 · N/P-  Joshua Smith,,21.95,,,,"5,693.74"
,,,,,,,6010 Advertising & Marketing,General Journal,,06/24/2019,,10125,,,,plants / lady bugs for moana Gh,,,,,,2500 · N/P-  Joshua Smith,,26.53,,,,"5,720.27"
,,,,,,,6010 Advertising & Marketing,Check,,06/26/2019,,,,Wix.Com,,06/25,,,,,,1010 · Chase 9063 -720,,4.95,,,,"5,725.22"
,,,,,,,6010 Advertising & Marketing,General Journal,,07/01/2019,,10128,,,,Rail City - plants and punch for Moana nursery gh,,,,,,2500 · N/P-  Joshua Smith,,144.29,,,,"5,869.51"
,,,,,,,6010 Advertising & Marketing,Check,,07/10/2019,,,,ADOBE,,87 CA        07/10,,,,,,1010 · Chase 9063 -720,,52.99,,,,"5,922.50"
,,,,,,,6010 Advertising & Marketing,Check,,07/10/2019,,,,ADOBE,,87 CA        07/10,,,,,,1010 · Chase 9063 -720,,9.99,,,,"5,932.49"
,,,,,,,6010 Advertising & Marketing,Check,,07/10/2019,,,,Precision Installation,,44 CA        07/09,,,,,,1010 · Chase 9063 -720,,103.48,,,,"6,035.97"
,,,,,,,6010 Advertising & Marketing,Check,,07/10/2019,,,,Wix.Com,,,,,,,,1000 · Checking BOA 2589,,14.50,,,,"6,050.47"
,,,,,,,6010 Advertising & Marketing,Check,,07/12/2019,,,,ADOBE,,87 CA        07/12,,,,,,1010 · Chase 9063 -720,,52.99,,,,"6,103.46"
,,,,,,,6010 Advertising & Marketing,Check,,07/12/2019,,,,HOME DEPOT,,702603  07/12,,,,,,1010 · Chase 9063 -720,,87.96,,,,"6,191.42"
,,,,,,,6010 Advertising & Marketing,Check,,07/18/2019,,,,Wix.Com,,07/17,,,,,,1010 · Chase 9063 -720,,36.00,,,,"6,227.42"
,,,,,,,6010 Advertising & Marketing,Check,,07/23/2019,,,,Pfalmer Productions,,,,,,,,1200 · Checking BOA 6959 MG,,"1,545.00",,,,"7,772.42"
,,,,,,,6010 Advertising & Marketing,Check,,07/26/2019,,,,Wix.Com,,07/25,,,,,,1010 · Chase 9063 -720,,4.95,,,,"7,777.37"
,,,,,,,6010 Advertising & Marketing,Credit Card Charge,,08/01/2019,,,,"SquareSpace, Inc",,,,,,,,1420 · Capital One,,216.00,,,,"7,993.37"
,,,,,,,6010 Advertising & Marketing,Check,,08/12/2019,,,,ADOBE,,87 CA        08/12,,,,,,1010 · Chase 9063 -720,,52.99,,,,"8,046.36"
,,,,,,,6010 Advertising & Marketing,Check,,08/12/2019,,,,ADOBE,,87 CA        08/10,,,,,,1010 · Chase 9063 -720,,9.99,,,,"8,056.35"
,,,,,,,6010 Advertising & Marketing,Credit Card Charge,,08/12/2019,,,,MOANA NURSERY,,,,,,,,1430 · Chase CC 1410,,25.96,,,,"8,082.31"
,,,,,,,6010 Advertising & Marketing,Check,,08/19/2019,,,,Wix.Com,,08/17,,,,,,1010 · Chase 9063 -720,,36.00,,,,"8,118.31"
,,,,,,,6010 Advertising & Marketing,Check,,08/19/2019,,,,Wix.Com,,08/16,,,,,,1010 · Chase 9063 -720,,14.50,,,,"8,132.81"
,,,,,,,6010 Advertising & Marketing,Check,,08/22/2019,,,,CRAIGSLIST,,,,,,,,1010 · Chase 9063 -720,,25.00,,,,"8,157.81"
,,,,,,,6010 Advertising & Marketing,Credit Card Charge,,08/25/2019,,,,MOANA NURSERY,,,,,,,,1430 · Chase CC 1410,,10.82,,,,"8,168.63"
,,,,,,,6010 Advertising & Marketing,Check,,08/28/2019,,,,Wix.Com,,08/25,,,,,,1010 · Chase 9063 -720,,4.95,,,,"8,173.58"
,,,,,,,6010 Advertising & Marketing,Check,,09/09/2019,,,,Wix.Com,,09/08,,,,,,1010 · Chase 9063 -720,,14.50,,,,"8,188.08"
,,,,,,,6010 Advertising & Marketing,Check,,09/10/2019,,,,ADOBE,,87 CA        09/10,,,,,,1010 · Chase 9063 -720,,9.99,,,,"8,198.07"
,,,,,,,6010 Advertising & Marketing,Check,,09/12/2019,,,,GO DADDY,,09/11,,,,,,1010 · Chase 9063 -720,,8.47,,,,"8,206.54"
,,,,,,,6010 Advertising & Marketing,Check,,09/12/2019,,,,ADOBE,,87 CA        09/12,,,,,,1010 · Chase 9063 -720,,52.99,,,,"8,259.53"
,,,,,,,6010 Advertising & Marketing,Check,,09/13/2019,,,,GO DADDY,,09/12,,,,,,1010 · Chase 9063 -720,,12.17,,,,"8,271.70"
,,,,,,,6010 Advertising & Marketing,Check,,09/19/2019,,,,Wix.Com,,09/17,,,,,,1010 · Chase 9063 -720,,36.00,,,,"8,307.70"
,,,,,,,6010 Advertising & Marketing,Check,,09/30/2019,,,,DIRECT Fairways,,09/27,,,,,,1010 · Chase 9063 -720,,"1,050.00",,,,"9,357.70"
,,,,,,,6010 Advertising & Marketing,Check,,09/30/2019,,,,Wix.Com,,09/25,,,,,,1010 · Chase 9063 -720,,4.95,,,,"9,362.65"
,,,,,,,6010 Advertising & Marketing,Check,,10/10/2019,,,,Wix.Com,,10/08,,,,,,1010 · Chase 9063 -720,,14.50,,,,"9,377.15"
,,,,,,,6010 Advertising & Marketing,Check,,10/10/2019,,,,ADOBE,,7 CA         10/10,,,,,,1010 · Chase 9063 -720,,9.99,,,,"9,387.14"
,,,,,,,6010 Advertising & Marketing,Credit Card Charge,,10/10/2019,,,,1 Stop Ranch & Feed,,,,,,,,1430 · Chase CC 1410,,43.25,,,,"9,430.39"
,,,,,,,6010 Advertising & Marketing,Check,,10/21/2019,,,,Wix.Com,,10/17,,,,,,1010 · Chase 9063 -720,,36.00,,,,"9,466.39"
,,,,,,,6010 Advertising & Marketing,Check,,10/22/2019,,1333,,MOANA NURSERY,,,,,,,,1010 · Chase 9063 -720,,"1,042.34",,,,"10,508.73"
,,,,,,,6010 Advertising & Marketing,Check,,10/28/2019,,,,Wix.Com,,10/25,,,,,,1010 · Chase 9063 -720,,4.95,,,,"10,513.68"
,,,,,,,6010 Advertising & Marketing,Check,,11/04/2019,,,,Cary Company,,11/01,,,,,,1010 · Chase 9063 -720,,254.52,,,,"10,768.20"
,,,,,,,6010 Advertising & Marketing,Check,,11/04/2019,,,,Cary Company,,11/01,,,,,,1010 · Chase 9063 -720,,4.08,,,,"10,772.28"
,,,,,,,6010 Advertising & Marketing,Credit Card Charge,,11/07/2019,,,,Ahrefs.com,,,,,,,,1430 · Chase CC 1410,,7.58,,,,"10,779.86"
,,,,,,,6010 Advertising & Marketing,Credit Card Charge,,11/10/2019,,,,Fiverr.com,,,,,,,,1430 · Chase CC 1410,,56.70,,,,"10,836.56"
,,,,,,,6010 Advertising & Marketing,Credit Card Charge,,11/10/2019,,,,Greenbrae Trophy,,,,,,,,1430 · Chase CC 1410,,99.00,,,,"10,935.56"
,,,,,,,6010 Advertising & Marketing,Check,,11/12/2019,,,,Wix.Com,,11/17,,,,,,1010 · Chase 9063 -720,,14.50,,,,"10,950.06"
,,,,,,,6010 Advertising & Marketing,Credit Card Charge,,11/14/2019,,,,Ahrefs.com,,,,,,,,1430 · Chase CC 1410,,107.17,,,,"11,057.23"
,,,,,,,6010 Advertising & Marketing,Check,,11/19/2019,,,,Wix.Com,,11/17,,,,,,1010 · Chase 9063 -720,,36.00,,,,"11,093.23"
,,,,,,,6010 Advertising & Marketing,Check,,11/29/2019,,,,Wix.Com,,11/25,,,,,,1010 · Chase 9063 -720,,4.95,,,,"11,098.18"
,,,,,,,6010 Advertising & Marketing,Check,,12/10/2019,,,,Wix.Com,,12/08,,,,,,1010 · Chase 9063 -720,,14.50,,,,"11,112.68"
,,,,,,,6010 Advertising & Marketing,Check,,12/10/2019,,,,ADOBE,,7 CA         12/10,,,,,,1010 · Chase 9063 -720,,9.99,,,,"11,122.67"
,,,,,,,6010 Advertising & Marketing,Credit Card Charge,,12/15/2019,,,,Ahrefs.com,,,,,,,,1430 · Chase CC 1410,,107.17,,,,"11,229.84"
,,,,,,,6010 Advertising & Marketing,Check,,12/18/2019,,,,Wix.Com,,11/17,,,,,,1010 · Chase 9063 -720,,36.00,,,,"11,265.84"
,,,,,,,6010 Advertising & Marketing,Check,,12/18/2019,,,,Wix.Com,,VOID: 12/17,,,,Ö,,1010 · Chase 9063 -720,,0.00,,,,"11,265.84"
,,,,,,,6010 Advertising & Marketing,Credit Card Charge,,12/20/2019,,,,KTVN,,,,,,,,1430 · Chase CC 1410,,"1,715.00",,,,"12,980.84"
,,,,,,,6010 Advertising & Marketing,Check,,12/26/2019,,,,Wix.Com,,11/25,,,,,,1010 · Chase 9063 -720,,4.95,,,,"12,985.79"
,,,,,,,6010 Advertising & Marketing,Check,,01/02/2020,,,,KTVN,,01/01,,,,,,1010 · Chase 9063 -720,,"1,000.00",,,,"13,985.79"
,,,,,,,6010 Advertising & Marketing,Check,,01/09/2020,,,,Wix.Com,,01/08,,,,,,1010 · Chase 9063 -720,,14.50,,,,"14,000.29"
,,,,,,,6010 Advertising & Marketing,Check,,01/10/2020,,,,ADOBE,,7 CA         01/10,,,,,,1010 · Chase 9063 -720,,9.99,,,,"14,010.28"
,,,,,,,6010 Advertising & Marketing,Credit Card Charge,,01/13/2020,,,,Ahrefs.com,,,,,,,,1430 · Chase CC 1410,,107.17,,,,"14,117.45"
,,,,,,,6010 Advertising & Marketing,Credit Card Charge,,01/14/2020,,,,Ahrefs.com,,VOID:,,,,Ö,,1430 · Chase CC 1410,,0.00,,,,"14,117.45"
,,,,,,,6010 Advertising & Marketing,Check,,01/17/2020,,,,KTVN,,01/16,,,,,,1010 · Chase 9063 -720,,"1,000.00",,,,"15,117.45"
,,,,,,,6010 Advertising & Marketing,Check,,01/21/2020,,,,Wix.Com,,01/17,,,,,,1010 · Chase 9063 -720,,36.00,,,,"15,153.45"
,,,,,,,6010 Advertising & Marketing,Check,,01/27/2020,,,,Wix.Com,,VOID: 12/25,,,,Ö,,1010 · Chase 9063 -720,,4.95,,,,"15,158.40"
,,,,,,,6010 Advertising & Marketing,Check,,02/05/2020,,,,CRAIGSLIST,,02/04,,,,,,1010 · Chase 9063 -720,,25.00,,,,"15,183.40"
,,,,,,,6010 Advertising & Marketing,Check,,02/05/2020,,,,Market place events,,LTHG 011dc2 WEB ID: 2262800364,,,,,,1010 · Chase 9063 -720,,"2,079.00",,,,"17,262.40"
,,,,,,,6010 Advertising & Marketing,Check,,02/10/2020,,,,Wix.Com,,02/08,,,,,,1010 · Chase 9063 -720,,14.50,,,,"17,276.90"
,,,,,,,6010 Advertising & Marketing,Check,,02/10/2020,,,,ADOBE,,7 CA         02/10,,,,,,1010 · Chase 9063 -720,,9.99,,,,"17,286.89"
,,,,,,,6010 Advertising & Marketing,Check,,02/19/2020,,,,Wix.Com,,02/17,,,,,,1010 · Chase 9063 -720,,36.00,,,,"17,322.89"
,,,,,,,6010 Advertising & Marketing,Check,,02/26/2020,,,,Wix.Com,,02/25,,,,,,1010 · Chase 9063 -720,,4.95,,,,"17,327.84"
,,,,,,,6010 Advertising & Marketing,Check,,03/09/2020,,,,Hyatt House,,03/07,,,,,,1010 · Chase 9063 -720,,707.69,,,,"18,035.53"
,,,,,,,6010 Advertising & Marketing,Check,,03/09/2020,,,,Hyatt House,,03/08,,,,,,1010 · Chase 9063 -720,,119.97,,,,"18,155.50"
,,,,,,,6010 Advertising & Marketing,Check,,03/09/2020,,,,Hyatt House,,03/08,,,,,,1010 · Chase 9063 -720,,120.74,,,,"18,276.24"
,,,,,,,6010 Advertising & Marketing,Check,,03/09/2020,,,,Baymont,,03/06,,,,,,1010 · Chase 9063 -720,,81.50,,,,"18,357.74"
,,,,,,,6010 Advertising & Marketing,Check,,03/09/2020,,,,MODern display expo,,UT          03/06,,,,,,1010 · Chase 9063 -720,,153.21,,,,"18,510.95"
,,,,,,,6010 Advertising & Marketing,Check,,03/09/2020,,,,TARGET,,03/07 Purchase $17.37 Cash Back,,,,,,1010 · Chase 9063 -720,,57.37,,,,"18,568.32"
,,,,,,,6010 Advertising & Marketing,Check,,03/09/2020,,,,TARGET,,03/07,,,,,,1010 · Chase 9063 -720,,38.61,,,,"18,606.93"
,,,,,,,6010 Advertising & Marketing,Check,,03/09/2020,,,,TARGET,,03/08,,,,,,1010 · Chase 9063 -720,,6.46,,,,"18,613.39"
,,,,,,,6010 Advertising & Marketing,Check,,03/10/2020,,,,Kolo tv,,03/09,,,,,,1010 · Chase 9063 -720,,"1,000.00",,,,"19,613.39"
,,,,,,,6010 Advertising & Marketing,Check,,03/10/2020,,,,Wix.Com,,03/08,,,,,,1010 · Chase 9063 -720,,14.50,,,,"19,627.89"
,,,,,,,6010 Advertising & Marketing,Check,,03/10/2020,,,,ADOBE,,0 CA         03/10,,,,,,1010 · Chase 9063 -720,,9.99,,,,"19,637.88"
,,,,,,,6010 Advertising & Marketing,Check,,03/11/2020,,,,Baymont,,03/09,,,,,,1010 · Chase 9063 -720,,75.80,,,,"19,713.68"
,,,,,,,6010 Advertising & Marketing,Check,,03/19/2020,,,,Wix.Com,,03/17,,,,,,1010 · Chase 9063 -720,,36.00,,,,"19,749.68"
,,,,,,,6010 Advertising & Marketing,Check,,03/26/2020,,,,FACEBOOK,,03/25,,,,,,1010 · Chase 9063 -720,,250.00,,,,"19,999.68"
,,,,,,,6010 Advertising & Marketing,Check,,03/27/2020,,,,Wix.Com,,03/25,,,,,,1010 · Chase 9063 -720,,4.95,,,,"20,004.63"
,,,,,,,6010 Advertising & Marketing,Check,,03/31/2020,,,,FACEBOOK,,03/31,,,,,,1010 · Chase 9063 -720,,50.00,,,,"20,054.63"
,,,,,,,6010 Advertising & Marketing,Check,,03/31/2020,,,,FACEBOOK,,03/31,,,,,,1010 · Chase 9063 -720,,23.85,,,,"20,078.48"
,,,,,,,6010 Advertising & Marketing,Check,,04/01/2020,,,,KTVN,,03/31,,,,,,1010 · Chase 9063 -720,,"1,275.00",,,,"21,353.48"
,,,,,,,6010 Advertising & Marketing,Check,,04/06/2020,,,,Wix.Com,,04/05,,,,,,1010 · Chase 9063 -720,,156.00,,,,"21,509.48"
,,,,,,,6010 Advertising & Marketing,Check,,04/10/2020,,,,ADOBE,,0 CA         04/10,,,,,,1010 · Chase 9063 -720,,9.99,,,,"21,519.47"
,,,,,,,6010 Advertising & Marketing,Check,,04/13/2020,,,,Wix.Com,,04/08,,,,,,1010 · Chase 9063 -720,,14.50,,,,"21,533.97"
,,,,,,,6010 Advertising & Marketing,Check,,04/21/2020,,,,Wix.Com,,04/17,,,,,,1010 · Chase 9063 -720,,36.00,,,,"21,569.97"
,,,,,,,6010 Advertising & Marketing,Check,,04/22/2020,,,,Pripartners,,,,,,,,1010 · Chase 9063 -720,,120.00,,,,"21,689.97"
,,,,,,,6010 Advertising & Marketing,Check,,04/23/2020,,,,Pripartners,,,,,,,,1010 · Chase 9063 -720,,40.00,,,,"21,729.97"
,,,,,,,6010 Advertising & Marketing,Check,,04/27/2020,,,,Wix.Com,,04/25,,,,,,1010 · Chase 9063 -720,,4.95,,,,"21,734.92"
,,,,,,,6010 Advertising & Marketing,Check,,04/30/2020,,,,FACEBOOK,,,,,,,,1010 · Chase 9063 -720,,237.98,,,,"21,972.90"
,,,,,,,6010 Advertising & Marketing,Check,,05/06/2020,,,,CRAIGSLIST,,05/06,,,,,,1010 · Chase 9063 -720,,3.00,,,,"21,975.90"
,,,,,,,6010 Advertising & Marketing,Check,,05/07/2020,,,,CRAIGSLIST,,05/07,,,,,,1010 · Chase 9063 -720,,25.00,,,,"22,000.90"
,,,,,,,6010 Advertising & Marketing,Check,,05/08/2020,,,,KTVN,,05/07,,,,,,1010 · Chase 9063 -720,,"1,075.00",,,,"23,075.90"
,,,,,,,6010 Advertising & Marketing,Check,,05/08/2020,,,,Hotwire,,05/08,,,,,,1010 · Chase 9063 -720,,139.99,,,,"23,215.89"
,,,,,,,6010 Advertising & Marketing,Check,,05/11/2020,,,,Hyatt House,,05/09,,,,,,1010 · Chase 9063 -720,,185.59,,,,"23,401.48"
,,,,,,,6010 Advertising & Marketing,Check,,05/11/2020,,,,Hyatt House,,05/10,,,,,,1010 · Chase 9063 -720,,185.59,,,,"23,587.07"
,,,,,,,6010 Advertising & Marketing,Check,,05/11/2020,,,,Wix.Com,,05/08,,,,,,1010 · Chase 9063 -720,,14.50,,,,"23,601.57"
,,,,,,,6010 Advertising & Marketing,Check,,05/11/2020,,,,ADOBE,,0 CA         05/10,,,,,,1010 · Chase 9063 -720,,9.99,,,,"23,611.56"
,,,,,,,6010 Advertising & Marketing,Check,,05/20/2020,,,,Wix.Com,,05/17,,,,,,1010 · Chase 9063 -720,,36.00,,,,"23,647.56"
,,,,,,,6010 Advertising & Marketing,Check,,05/26/2020,,,,Wix.Com,,05/25,,,,,,1010 · Chase 9063 -720,,4.95,,,,"23,652.51"
,,,,,,,6010 Advertising & Marketing,Check,,05/26/2020,,,,CRAIGSLIST,,05/23,,,,,,1010 · Chase 9063 -720,,3.00,,,,"23,655.51"
,,,,,,,6010 Advertising & Marketing,Check,,06/05/2020,,,,Ahrefs.com,,06/04,,,,,,1010 · Chase 9063 -720,,30.00,,,,"23,685.51"
,,,,,,,6010 Advertising & Marketing,Check,,06/05/2020,,,,Ahrefs.com,,06/04,,,,,,1010 · Chase 9063 -720,,30.00,,,,"23,715.51"
,,,,,,,6010 Advertising & Marketing,Check,,06/05/2020,,,,Ahrefs.com,,06/04,,,,,,1010 · Chase 9063 -720,,99.00,,,,"23,814.51"
,,,,,,,6010 Advertising & Marketing,Check,,06/09/2020,,,,Wix.Com,,06/08,,,,,,1010 · Chase 9063 -720,,14.50,,,,"23,829.01"
,,,,,,,6010 Advertising & Marketing,Check,,06/09/2020,,,,Utah Home Show,,06/08,,,,,,1010 · Chase 9063 -720,,"1,500.00",,,,"25,329.01"
,,,,,,,6010 Advertising & Marketing,Check,,06/10/2020,,,,ADOBE,,0 CA         06/10,,,,,,1010 · Chase 9063 -720,,9.99,,,,"25,339.00"
,,,,,,,6010 Advertising & Marketing,Check,,06/11/2020,,,,CRAIGSLIST,,06/11,,,,,,1010 · Chase 9063 -720,,25.00,,,,"25,364.00"
,,,,,,,6010 Advertising & Marketing,Check,,06/12/2020,,,,amazon,,ll WA        06/11,,,,,,1010 · Chase 9063 -720,,23.99,,,,"25,387.99"
,,,,,,,6010 Advertising & Marketing,Check,,06/22/2020,,,,Wix.Com,,06/17,,,,,,1010 · Chase 9063 -720,,36.00,,,,"25,423.99"
,,,,,,,6010 Advertising & Marketing,Check,,06/29/2020,,,,Wix.Com,,06/25,,,,,,1010 · Chase 9063 -720,,4.95,,,,"25,428.94"
,,,,,,,6010 Advertising & Marketing,Check,,07/06/2020,,,,Ahrefs.com,,07/04,,,,,,1010 · Chase 9063 -720,,159.00,,,,"25,587.94"
,,,,,,,6010 Advertising & Marketing,General Journal,,07/06/2020,,010119-28sc,,,,Moana Nursery - Cash,,,,,,2500 · N/P-  Joshua Smith,,68.86,,,,"25,656.80"
,,,,,,,6010 Advertising & Marketing,Credit Card Charge,,07/08/2020,,,,MOANA NURSERY,,,,,,,,1430 · Chase CC 1410,,174.66,,,,"25,831.46"
,,,,,,,6010 Advertising & Marketing,Credit Card Charge,,07/09/2020,,,,Moana Beds,,,,,,,,1430 · Chase CC 1410,,16.21,,,,"25,847.67"
,,,,,,,6010 Advertising & Marketing,Check,,07/10/2020,,,,ADOBE,,0 CA         07/10,,,,,,1010 · Chase 9063 -720,,9.99,,,,"25,857.66"
,,,,,,,6010 Advertising & Marketing,Check,,07/13/2020,,,,Wix.Com,,07/08,,,,,,1010 · Chase 9063 -720,,14.50,,,,"25,872.16"
,,,,,,,6010 Advertising & Marketing,Credit Card Charge,,07/14/2020,,,,MOANA NURSERY,,,,,,,,1430 · Chase CC 1410,,17.86,,,,"25,890.02"
,,,,,,,6010 Advertising & Marketing,Check,,07/21/2020,,,,Wix.Com,,07/17,,,,,,1010 · Chase 9063 -720,,36.00,,,,"25,926.02"
,,,,,,,6010 Advertising & Marketing,Credit Card Charge,,07/26/2020,,,,Green's Feed,,,,,,,,1430 · Chase CC 1410,,32.32,,,,"25,958.34"
,,,,,,,6010 Advertising & Marketing,Check,,07/27/2020,,,,Wix.Com,,07/25,,,,,,1010 · Chase 9063 -720,,4.95,,,,"25,963.29"
,,,,,,,6010 Advertising & Marketing,Check,,08/05/2020,,,,Ahrefs.com,,08/04,,,,,,1010 · Chase 9063 -720,,159.00,,,,"26,122.29"
,,,,,,,6010 Advertising & Marketing,Check,,08/10/2020,,,,ADOBE,,0 CA         08/10,,,,,,1010 · Chase 9063 -720,,9.99,,,,"26,132.28"
,,,,,,,6010 Advertising & Marketing,Check,,08/11/2020,,,,Wix.Com,,08/08,,,,,,1010 · Chase 9063 -720,,14.50,,,,"26,146.78"
,,,,,,,6010 Advertising & Marketing,Credit Card Charge,,08/18/2020,,,,"SquareSpace, Inc",,,,,,,,1420 · Capital One,,216.00,,,,"26,362.78"
,,,,,,,6010 Advertising & Marketing,Check,,08/19/2020,,,,CRAIGSLIST,,08/19,,,,,,1010 · Chase 9063 -720,,25.00,,,,"26,387.78"
,,,,,,,6010 Advertising & Marketing,Check,,08/19/2020,,,,CRAIGSLIST,,08/19,,,,,,1010 · Chase 9063 -720,,25.00,,,,"26,412.78"
,,,,,,,6010 Advertising & Marketing,Check,,08/19/2020,,,,Wix.Com,,08/17,,,,,,1010 · Chase 9063 -720,,36.00,,,,"26,448.78"
,,,,,,,6010 Advertising & Marketing,Check,,08/31/2020,,,,Wix.Com,,08/25,,,,,,1010 · Chase 9063 -720,,4.95,,,,"26,453.73"
,,,,,,,6010 Advertising & Marketing,Check,,09/08/2020,,,,Ahrefs.com,,09/04,,,,,,1010 · Chase 9063 -720,,159.00,,,,"26,612.73"
,,,,,,,6010 Advertising & Marketing,Check,,09/09/2020,,,,CRAIGSLIST,,09/09,,,,,,1010 · Chase 9063 -720,,3.00,,,,"26,615.73"
,,,,,,,6010 Advertising & Marketing,Check,,09/10/2020,,,,Wix.Com,,09/08,,,,,,1010 · Chase 9063 -720,,14.50,,,,"26,630.23"
,,,,,,,6010 Advertising & Marketing,Check,,09/10/2020,,,,ADOBE,,0 CA         09/10,,,,,,1010 · Chase 9063 -720,,9.99,,,,"26,640.22"
,,,,,,,6010 Advertising & Marketing,Check,,09/18/2020,,,,Wix.Com,,NY          09/17,,,,,,1010 · Chase 9063 -720,,36.00,,,,"26,676.22"
,,,,,,,6010 Advertising & Marketing,Credit Card Charge,,09/18/2020,,,,MOANA NURSERY,,,,,,,,1430 · Chase CC 1410,,10.47,,,,"26,686.69"
,,,,,,,6010 Advertising & Marketing,Check,,09/28/2020,,,,Wix.Com,,09/25,,,,,,1010 · Chase 9063 -720,,4.95,,,,"26,691.64"
,,,,,,,6010 Advertising & Marketing,Check,,09/29/2020,,,,CRAIGSLIST,,09/29,,,,,,1010 · Chase 9063 -720,,25.00,,,,"26,716.64"
,,,,,,,6010 Advertising & Marketing,Check,,09/29/2020,,,,CRAIGSLIST,,09/29,,,,,,1010 · Chase 9063 -720,,25.00,,,,"26,741.64"
,,,,,,,6010 Advertising & Marketing,Credit Card Charge,,10/14/2020,,,,Vimeo.Com,,,,,,,,1420 · Capital One,,240.00,,,,"26,981.64"
,,,,Total 6010 · Advertising & Marketing,,,,,,,,,,,,,,,,,,,,"27,106.78",,125.14,,"26,981.64"