,"Type","Date","Num","Memo","Name","Item","Qty","U/M","Sales Price","Amount","Balance"
,"Invoice","06/27/2019","37","Discontinued Model  2' x 8' x 26""  w/ 16""  cover","Andy Hanson","Custom Greenhouse",3,,1000.00,3000.00,3000.00
,"Invoice","06/27/2019","37","Discount - Carson Home Show","Andy Hanson","Discount (Discount)","",,-300.00,-300.00,2700.00
,"Invoice","06/27/2019","37","Raised Bed Delivery","Andy Hanson","Raised Bed Delivery (Raised Bed Delivery)",1,,75.00,75.00,2775.00
,"Invoice","05/06/2020","101","8' x 16' Modular Greenhouse","Andy Michelson","8' x 16' Greenhouse (8' x 16' Modular Greenhouse)",1,,4495.00,4495.00,4495.00
,"Invoice","05/06/2020","101","Automatic Pop Vent","Andy Michelson","Pop Vent (Automatic Pop Vent)",4,"ea",89.00,356.00,4851.00
,"Invoice","05/06/2020","101","Electric Swamp Cooler Large","Andy Michelson","Swamp Cooler Large (Electric Swamp Cooler Large)",1,"ea",600.00,600.00,5451.00
,"Invoice","05/06/2020","101","8"" Shelf Bed - 4'","Andy Michelson","8"" Shelf Bed -4' (8"" Shelf Bed - 4')",4,,99.95,399.80,5850.80
,"Invoice","05/06/2020","101","8""  Raised Bed - 4'","Andy Michelson","8""  Raised Bed -4' (8""  Raised Bed - 4')",4,,69.95,279.80,6130.60
,"Invoice","05/06/2020","101","26"" Raised Bed","Andy Michelson","26""  Raised Bed (26"" Raised Bed)",4,,97.95,391.80,6522.40
,"Invoice","05/06/2020","101","4"" Concrete Tapcons","Andy Michelson","Anchors - Concrete (4"" Concrete Tapcons)",9,"ea",2.00,18.00,6540.40
,"Invoice","05/06/2020","101","Delivery & Install","Andy Michelson","Install (Delivery & Install)",1,,915.60,915.60,7456.00
,"Invoice","06/29/2020","115","8' x 16' w/ Side Cathedral Modular Greenhouse","Anita and Alan Boucher","8' x 16' GH Side Cathedral (8' x 16' w/ Side Cathedral Modular Greenhouse)",1,,5249.00,5249.00,5249.00
,"Invoice","06/29/2020","115","26"" Raised Bed","Anita and Alan Boucher","26""  Raised Bed (26"" Raised Bed)",4,,97.95,391.80,5640.80
,"Invoice","06/29/2020","115","*** Custom: 16"" x 48"" Shelf","Anita and Alan Boucher","4' Shelf (4' Shelf)",4,,112.43,449.72,6090.52
,"Invoice","06/29/2020","115","*** Custom: 13' Raised Bed","Anita and Alan Boucher","18'  Raised Bed (18' Raised Bed)",2,,89.95,179.90,6270.42
,"Invoice","06/29/2020","115","*** Custom: 16"" x 4' x 8"" Shelf Bed","Anita and Alan Boucher","8"" Shelf Bed -4' (8"" Shelf Bed - 4')",2,,99.95,199.90,6470.32
,"Invoice","06/29/2020","115","18"" Ground Anchor","Anita and Alan Boucher","Ground Anchors (18"" Ground Anchor)",11,,30.49,335.39,6805.71
,"Invoice","06/29/2020","115","Z Bracket","Anita and Alan Boucher","Z Bracket (Z Bracket)",11,,11.23,123.53,6929.24
,"Invoice","06/29/2020","115","Automatic Pop Vent","Anita and Alan Boucher","Pop Vent (Automatic Pop Vent)",4,"ea",89.00,356.00,7285.24
,"Invoice","06/29/2020","115","Delivery & Install","Anita and Alan Boucher","Install (Delivery & Install)",1,,917.84,917.84,8203.08
,"Invoice","06/29/2020","115","10% Veteran Discount","Anita and Alan Boucher","10% Veteran Discount","",,-10.00%,-820.31,7382.77
,"Invoice","08/30/2019","49","8' x 16' w/ Side Cathedral Modular Greenhouse","Anne Brandvold Adriaan Van Der Capellen","8' x 16' GH Side Cathedral (8' x 16' w/ Side Cathedral Modular Greenhouse)",1,,5249.00,5249.00,5249.00
,"Invoice","08/30/2019","49","Discount  5% (Website - went to Moana)","Anne Brandvold Adriaan Van Der Capellen","Discount (Discount)","",,-262.00,-262.00,4987.00
,"Invoice","08/30/2019","49","18' Ground Anchor","Anne Brandvold Adriaan Van Der Capellen","Ground Anchors (18"" Ground Anchor)",11,,30.49,335.39,5322.39
,"Invoice","08/30/2019","49","Z Bracket","Anne Brandvold Adriaan Van	 Der Capellen","Z Bracket (Z Bracket)",11,,11.23,123.53,5445.92
,"Invoice","08/30/2019","49","Solar Fan","Anne Brandvold Adriaan Van Der Capellen","Solar Fan 20"" (Solar Fan)",1,,750.10,750.10,6196.02
,"Invoice","08/30/2019","49","Dual Circuit Thermostat","Anne Brandvold Adriaan Van Der Capellen","Thermostatx (Dual Circuit Thermostat)",1,,29.95,29.95,6225.97
,"Invoice","08/30/2019","49","Self-opening automatic roof vent","Anne Brandvold Adriaan Van Der Capellen","Automatic Roof Vent (Self-opening automatic roof vent)",4,,65.10,260.40,6486.37
,"Invoice","08/30/2019","49","Univent OT Standard","Anne Brandvold Adriaan Van Der Capellen","Univent OTStandard (Univent OT Standard)",4,,23.90,95.60,6581.97
,"Invoice","08/30/2019","49","26"" Raised Bed","Anne Brandvold Adriaan Van Der Capellen","26""  Raised Bed (26"" Raised Bed)",3,,97.95,293.85,6875.82
,"Invoice","08/30/2019","49","8""  Raised Bed - 4'","Anne Brandvold Adriaan Van Der Capellen","8""  Raised Bed -4' (8""  Raised Bed - 4')",2,,69.95,139.90,7015.72
,"Invoice","08/30/2019","49","8"" Shelf Bed - 4'","Anne Brandvold Adriaan Van Der Capellen","8"" Shelf Bed -4' (8"" Shelf Bed - 4')",2,,99.95,199.90,7215.62
,"Invoice","08/30/2019","49","4' Shelf","Anne Brandvold Adriaan Van Der Capellen","4' Shelf (4' Shelf)",1,,74.95,74.95,7290.57
,"Invoice","08/30/2019","49","Delivery & Install","Anne Brandvold Adriaan Van Der Capellen","Install (Delivery & Install)",1,,1000.00,1000.00,8290.57
,"Invoice","08/30/2019","49","Additional $100 for every 25 miles outside Reno/Sparks","Anne Brandvold Adriaan Van Der Capellen","Additional Delivery Fee (Additional $100 for every 25 miles outside Reno/Sparks)",1,,100.00,100.00,8390.57
,"Invoice","01/03/2020","61","8' x 16' Modular Greenhouse","Barbara Kaufman","8' x 16' Greenhouse (8' x 16' Modular Greenhouse)",1,,4495.00,4495.00,4495.00
,"Invoice","01/03/2020","61","8mm Polycarb Upgrade","Barbara Kaufman","8mm Polycarb Upgrade (8mm Polycarb Upgrade)",1,,449.50,449.50,4944.50
,"Invoice","01/03/2020","61","18' Ground Anchor","Barbara Kaufman","Ground Anchors (18"" Ground Anchor)",11,,30.49,335.39,5279.89
,"Invoice","01/03/2020","61","Z Bracket","Barbara Kaufman","Z Bracket (Z Bracket)",11,,11.23,123.53,5403.42
,"Invoice","01/03/2020","61","Self-opening automatic roof vent","Barbara Kaufman","Automatic Roof Vent (Self-opening automatic roof vent)",6,,65.10,390.60,5794.02
,"Invoice","01/03/2020","61","Univent OT Standard","Barbara Kaufman","Univent OTStandard (Univent OT Standard)",6,,23.90,143.40,5937.42
,"Invoice","01/03/2020","61","Solar Fan","Barbara Kaufman","Solar Fan 20"" (Solar Fan)",1,,750.10,750.10,6687.52
,"Invoice","01/03/2020","61","Dual Circuit Thermostat","Barbara Kaufman","Thermostatx (Dual Circuit Thermostat)",1,,29.95,29.95,6717.47
,"Invoice","01/03/2020","61","Discount","Barbara Kaufman","Discount (Discount)","",,-494.45,-494.45,6223.02
,"Invoice","01/03/2020","61","Delivery & Install","Barbara Kaufman","Install (Delivery & Install)",1,,1000.00,1000.00,7223.02
,"Invoice","01/03/2020","61","Additional $100 for every 25 miles outside Reno/Sparks","Barbara Kaufman","Additional Delivery Fee (Additional $100 for every 25 miles outside Reno/Sparks)",1,,100.00,100.00,7323.02
,"Invoice","01/03/2020","61","24ï¿½ Siding around Greenhouse","Barbara Kaufman","Custom Build Accessories",1,,450.00,450.00,7773.02
,"Invoice","08/12/2020","126","8' x 8' Modular Greenhouse","Becky Angeli","8' x 8' Greenhouse (8' x 8' Modular Greenhouse)",1,,3199.00,3199.00,3199.00
,"Invoice","08/12/2020","126","Automatic Pop Vent","Becky Angeli","Pop Vent (Automatic Pop Vent)",1,"ea",89.00,89.00,3288.00
,"Invoice","08/12/2020","126","18"" Ground Anchor","Becky Angeli","Ground Anchors (18"" Ground Anchor)",7,,30.49,213.43,3501.43
,"Invoice","08/12/2020","126","Z Bracket","Becky Angeli","Z Bracket (Z Bracket)",7,,11.23,78.61,3580.04
,"Invoice","08/12/2020","126","Aprilaire 500 Whole Home Humidifier (Shipping included)","Becky Angeli","Humidifier",1,,160.00,160.00,3740.04
,"Invoice","08/12/2020","126","30,000 BTU Vent Free Blue Flame Natural Gas Heater (Shipping included)","Becky Angeli","Gas Heater",1,,195.00,195.00,3935.04
,"Invoice","08/12/2020","126","Electric Swamp Cooler Large (Shipping included)","Becky Angeli","Swamp Cooler Large (Electric Swamp Cooler Large)",1,"ea",600.00,600.00,4535.04
,"Invoice","08/12/2020","126","4' Shelf","Becky Angeli","4' Shelf (4' Shelf)",2,,74.95,149.90,4684.94
,"Invoice","08/12/2020","126","13"" Raised Bed","Becky Angeli","13"" Raised Bed",2,,69.95,139.90,4824.84
,"Invoice","08/12/2020","126","Delivery & Install","Becky Angeli","Install (Delivery & Install)","",,14.00%,675.48,5500.32
,"Invoice","02/04/2019","3","8' x 20' Modular Greenhouse","Ben Williams","8'x20' Modular Greenhouse (8' x 20' Modular Greenhouse)",1,,4685.00,4685.00,4685.00
,"Invoice","02/04/2019","3","Discount - end of year discount","Ben Williams","Discount (Discount)","",,-674.25,-674.25,4010.75
,"Invoice","02/04/2019","3","Discount- older flyer price","Ben Williams","Discount (Discount)","",,-190.00,-190.00,3820.75
,"Invoice","02/04/2019","3","Delivery & Install 8 x 20","Ben Williams","Install 8 x 20 (Delivery & Install 8 x 20)",1,,450.00,450.00,4270.75
,"Invoice","02/04/2019","3","24' Ground Anchor","Ben Williams","Ground Anchors - 26"" (26"" Ground Anchors)",13,,40.92,531.96,4802.71
,"Invoice","02/04/2019","3","Z Bracket","Ben Williams","Z Bracket (Z Bracket)",1,,8.70,8.70,4811.41
,"Invoice","02/04/2019","3","Self-opening automatic roof vent","Ben Williams","Automatic Roof Vent (Self-opening automatic roof vent)",6,,65.10,390.60,5202.01
,"Invoice","02/04/2019","3","Univent OT Standard","Ben Williams","Univent OTStandard (Univent OT Standard)",6,,23.90,143.40,5345.41
,"Invoice","02/04/2019","3","8' Shelf Bed - 4'","Ben Williams","8"" Shelf Bed -4' (8"" Shelf Bed - 4')",2,,99.95,199.90,5545.31
,"Invoice","02/04/2019","3","Additional Door","Ben Williams","Additional Door (Additional Door)",1,,350.00,350.00,5895.31
,"Invoice","03/31/2020","83","8' x 24' Modular Greenhouse","Bill & Judy Michelson","8'x24' Modular Greenhouse (8' x 24' Modular Greenhouse)",1,,5995.00,5995.00,5995.00
,"Invoice","03/31/2020","83","Wind/Snow Package","Bill & Judy Michelson","Wind/Snow Package (Wind/Snow Package)",6,,140.00,840.00,6835.00
,"Invoice","03/31/2020","83","Automatic Pop Vent","Bill & Judy Michelson","Pop Vent (Automatic Pop Vent)",6,"ea",89.00,534.00,7369.00
,"Invoice","03/31/2020","83","26"" Raised Bed","Bill & Judy Michelson","26""  Raised Bed (26"" Raised Bed)",6,,97.95,587.70,7956.70
,"Invoice","03/31/2020","83","8"" Shelf Bed - 4'","Bill & Judy Michelson","8"" Shelf Bed -4' (8"" Shelf Bed - 4')",6,,99.95,599.70,8556.40
,"Invoice","03/31/2020","83","8""  Raised Bed - 4'","Bill & Judy Michelson","8""  Raised Bed -4' (8""  Raised Bed - 4')",6,,69.95,419.70,8976.10
,"Invoice","03/31/2020","83"," Swamp Cooler with Thermostat & Shutter Vent","Bill & Judy Michelson","Swamp Cooler Large (Electric Swamp Cooler Large)",1,"ea",589.00,589.00,9565.10
,"Invoice","03/31/2020","83","4"" Concrete Tapcons","Bill & Judy Michelson","Anchors - Concrete (4"" Concrete Tapcons)",30,"ea",4.00,120.00,9685.10
,"Invoice","03/31/2020","83","Delivery & Install","Bill & Judy Michelson","Install (Delivery & Install)",1,,1320.00,1320.00,11005.10
,"Invoice","03/31/2020","83","Additional $100 for every 25 miles outside Reno/Sparks (comp per Josh)","Bill & Judy Michelson","Additional Delivery Fee (Additional $100 for every 25 miles outside Reno/Sparks)",0,,200.00,0.00,11005.10
,"Invoice","03/31/2020","83","Discount","Bill & Judy Michelson","Discount (Discount)","",,-10.00%,-1100.51,9904.59
,"Invoice","03/15/2019","10","8' x 12' Modular Greenhouse","brad watega","8' x 12' Greenhouse (8' x 12' Modular Greenhouse)",1,,3395.00,3395.00,3395.00
,"Invoice","03/15/2019","10","Discount Home & Garden Show","brad watega","Discount (Discount)","",,-340.00,-280.00,3115.00
,"Invoice","03/15/2019","10","Concrete Anchor","brad watega","Concrete  Anchors",1,,50.00,50.00,3165.00
,"Invoice","03/15/2019","10","Delivery & Install 8 x 12","brad watega","Install 8 x 12 (Delivery & Install 8 x 12)",1,,350.00,350.00,3515.00
,"Invoice","03/15/2019","10","Discount - free Install","brad watega","Discount (Discount)","",,-350.00,-300.00,3215.00
,"Invoice","03/15/2019","10","Self-opening automatic roof vent","brad watega","Automatic Roof Vent (Self-opening automatic roof vent)",2,,65.10,130.20,3345.20
,"Invoice","03/15/2019","10","Univent OT Standard","brad watega","Univent OTStandard (Univent OT Standard)",2,,23.90,47.80,3393.00
,"Invoice","03/15/2019","10","26' Raised Bed","brad watega","26""  Raised Bed (26"" Raised Bed)",3,,97.95,293.85,3686.85
,"Invoice","03/15/2019","10","8' Raised Bed - 4'","brad watega","8""  Raised Bed -4' (8""  Raised Bed - 4')",3,,69.95,209.85,3896.70
,"Invoice","03/15/2019","10","8' Shelf Bed - 4'","brad watega","8"" Shelf Bed -4' (8"" Shelf Bed - 4')",3,,99.95,299.85,4196.55
,"Invoice","03/15/2019","10"," Swamp Cooler","brad watega","Electric Swamp Cooler Largex ( Swamp Cooler)",1,,600.00,600.00,4796.55
,"Invoice","03/15/2019","10","Delivery & Install","brad watega","Accessory Install (Delivery & Install)",1,,75.00,75.00,4871.55
,"Invoice","03/15/2019","10","Discount - install and retrip","brad watega","Discount (Discount)","",,-28.86,-28.86,4842.69
,"Invoice","09/21/2020","133","8' x 12' Modular Greenhouse","Bruce Miller","8' x 12' Greenhouse (8' x 12' Modular Greenhouse)",1,,3749.00,3749.00,3749.00
,"Invoice","09/21/2020","133","Automatic Pop Vent","Bruce Miller","Pop Vent (Automatic Pop Vent)",1,"ea",89.00,89.00,3838.00
,"Invoice","09/21/2020","133","18"" Ground Anchor","Bruce Miller","Ground Anchors (18"" Ground Anchor)",9,,30.49,274.41,4112.41
,"Invoice","09/21/2020","133","Z Bracket","Bruce Miller","Z Bracket (Z Bracket)",9,,11.23,101.07,4213.48
,"Invoice","09/21/2020","133","4' Shelf","Bruce Miller","4' Shelf (4' Shelf)",6,,74.95,449.70,4663.18
,"Invoice","09/21/2020","133","12' 110v Electric Fan w/ Shutters","Bruce Miller","12' Shutter Fan (12' 110v Electric Fan w/ Shutters)",1,,169.00,169.00,4832.18
,"Invoice","09/21/2020","133","Dual Circuit Thermostat","Bruce Miller","Thermostat (Dual Circuit Thermostat)",1,"ea",29.99,29.99,4862.17
,"Invoice","09/21/2020","133","12' Shutter Vent","Bruce Miller","12' Shutter Vent (12' Shutter Vent)",1,,29.95,29.95,4892.12
,"Invoice","09/21/2020","133","Shipping from Reno, NV to Idaho Falls, ID - 615 miles, 1-2 Standard Pallets (Estimated cost - ac...","Bruce Miller","Shipping/Delivery",1,,800.00,800.00,5692.12
,"Invoice","04/11/2019","21","18' Ground Anchor","Bruce Parks","Ground Anchors (18"" Ground Anchor)",2,,27.88,55.76,55.76
,"Invoice","04/11/2019","21","Z Bracket","Bruce Parks","Z Bracket (Z Bracket)",2,,8.70,17.40,73.16
,"Invoice","02/25/2020","70","8' x 12' Modular Greenhouse","Candy & Jim Van Meteer","8' x 12' Greenhouse (8' x 12' Modular Greenhouse)",1,,3749.00,3749.00,3749.00
,"Invoice","02/25/2020","70","Sales Discount 10% + 5% KA","Candy & Jim Van Meteer","10% Sales Discount (Sales Discount 10%)","",,-15.00%,-562.35,3186.65
,"Invoice","02/25/2020","70","18' Ground Anchor","Candy & Jim Van Meteer","Ground Anchors (18"" Ground Anchor)",9,,30.49,274.41,3461.06
,"Invoice","02/25/2020","70","Z Bracket","Candy & Jim Van Meteer","Z Bracket (Z Bracket)",9,,11.23,101.07,3562.13
,"Invoice","02/25/2020","70","Self-opening automatic roof vent","Candy & Jim Van Meteer","Automatic Roof Vent (Self-opening automatic roof vent)",2,,65.10,130.20,3692.33
,"Invoice","02/25/2020","70","Univent OT Standard","Candy & Jim Van Meteer","Univent OTStandard (Univent OT Standard)",2,,23.90,47.80,3740.13
,"Invoice","02/25/2020","70"," Swamp Cooler","Candy & Jim Van Meteer","Electric Swamp Cooler small ( Swamp Cooler)",1,,450.00,450.00,4190.13
,"Invoice","02/25/2020","70","18' Raised Bed","Candy & Jim Van Meteer","18'  Raised Bed (18' Raised Bed)",3,,89.95,269.85,4459.98
,"Invoice","02/25/2020","70","8"" Shelf Bed - 4'","Candy & Jim Van Meteer","8"" Shelf Bed -4' (8"" Shelf Bed - 4')",3,,99.95,299.85,4759.83
,"Invoice","02/25/2020","70","8""  Raised Bed - 4'","Candy & Jim Van Meteer","8""  Raised Bed -4' (8""  Raised Bed - 4')",3,,69.95,209.85,4969.68
,"Invoice","02/25/2020","70","Delivery & Install","Candy & Jim Van Meteer","Install (Delivery & Install)",1,,850.00,850.00,5819.68
,"Invoice","02/25/2020","70",,"Candy & Jim Van Meteer","Ground Fencingx (Ground fencing under entire greenhouse)",1,,150.00,150.00,5969.68
,"Invoice","03/27/2019","22","18' Ground Anchor","Carmelita Haltom","Ground Anchors (18"" Ground Anchor)",1,,27.88,27.88,27.88
,"Invoice","04/24/2020","90","8' x 20' Greenhouse w/ 4' Pop-out","Carol Broersma","8'x20' Greenhouse w/ 4' Pop-out (8' x 20' Greenhouse w/ 4' Pop-out)",1,,6749.00,6749.00,6749.00
,"Invoice","04/24/2020","90","Automatic Pop Vent","Carol Broersma","Pop Vent (Automatic Pop Vent)",5,"ea",89.00,445.00,7194.00
,"Invoice","04/24/2020","90","8"" Shelf Bed - 4'","Carol Broersma","8"" Shelf Bed -4' (8"" Shelf Bed - 4')",6,,99.95,599.70,7793.70
,"Invoice","04/24/2020","90","18"" Ground Anchor","Carol Broersma","Ground Anchors (18"" Ground Anchor)",15,,30.49,457.35,8251.05
,"Invoice","04/24/2020","90","Z Bracket","Carol Broersma","Z Bracket (Z Bracket)",15,,11.23,168.45,8419.50
,"Invoice","04/24/2020","90","Solar Fan 16ï¿½","Carol Broersma","Solar Fan 16ï¿½ (Solar Fan 16ï¿½)",1,"ea",620.20,620.20,9039.70
,"Invoice","04/24/2020","90","Dual Circuit Thermostat","Carol Broersma","Thermostat (Dual Circuit Thermostat)",1,"ea",29.99,29.99,9069.69
,"Invoice","04/24/2020","90","4' Shelf","Carol Broersma","4' Shelf (4' Shelf)",2,,74.95,149.90,9219.59
,"Invoice","04/24/2020","90","1 person install","Carol Broersma","Shipping/Delivery",1,,250.00,250.00,9469.59
,"Invoice","04/24/2020","90","Solar Swamp Cooler Beta Test (Swamp Cooler, Solar Panels, Inverter, Battery)","Carol Broersma","Smart Tech Beta Kit",1,,650.00,650.00,10119.59
,"Invoice","04/24/2020","90","Delivery & Install","Carol Broersma","Install (Delivery & Install)","",,14.00%,91.00,10210.59
,"Invoice","07/11/2019","35","8' x 16' Greenhouse w/ 4' Pop-out","Chi Duong","8'x16' Greenhouse w/ 4' Pop-out (8' x 16' Greenhouse w/ 4' Pop-out)",1,,5995.00,5995.00,5995.00
,"Invoice","07/11/2019","35","Discount","Chi Duong","Discount (Discount)","",,-600.00,-600.00,5395.00
,"Invoice","07/11/2019","35","18' Ground Anchor","Chi Duong","Ground Anchors (18"" Ground Anchor)",13,,30.49,396.37,5791.37
,"Invoice","07/11/2019","35","Z Bracket","Chi Duong","Z Bracket (Z Bracket)",13,,11.23,145.99,5937.36
,"Invoice","07/11/2019","35","Solar Fan","Chi Duong","Solar Fan 20"" (Solar Fan)",1,,750.10,750.10,6687.46
,"Invoice","07/11/2019","35","Dual Circuit Thermostat","Chi Duong","Thermostatx (Dual Circuit Thermostat)",1,,29.95,29.95,6717.41
,"Invoice","07/11/2019","35","16"" Shutter Vent","Chi Duong","16' Shutter Vent (16"" Shutter Vent)",1,"ea",42.25,42.25,6759.66
,"Invoice","07/11/2019","35","Discount","Chi Duong","Discount (Discount)","",,-321.70,-295.00,6464.66
,"Invoice","07/11/2019","35","Delivery & Install","Chi Duong","Install (Delivery & Install)",1,,720.00,720.00,7184.66
,"Invoice","07/11/2019","35","Self-opening automatic roof vent","Chi Duong","Automatic Roof Vent (Self-opening automatic roof vent)",2,,65.10,130.20,7314.86
,"Invoice","07/11/2019","35","Univent OT Standard","Chi Duong","Univent OTStandard (Univent OT Standard)",2,,23.90,47.80,7362.66
,"Invoice","04/30/2020","94","8' x 12' Modular Greenhouse","Chris Vivian","8' x 12' Greenhouse (8' x 12' Modular Greenhouse)",1,,3749.00,3749.00,3749.00
,"Invoice","04/30/2020","94","Automatic Pop Vent","Chris Vivian","Pop Vent (Automatic Pop Vent)",3,"ea",89.00,267.00,4016.00
,"Invoice","04/30/2020","94","Wind/Snow Package","Chris Vivian","Wind/Snow Package (Wind/Snow Package)",6,,75.00,450.00,4466.00
,"Invoice","04/30/2020","94"," Swamp Cooler w/ Thermostat","Chris Vivian","Swamp Cooler Large (Electric Swamp Cooler Large)",1,"ea",600.00,600.00,5066.00
,"Invoice","04/30/2020","94","4' Shelf","Chris Vivian","4' Shelf (4' Shelf)",3,,74.95,224.85,5290.85
,"Invoice","04/30/2020","94","8""  Raised Bed - 4'","Chris Vivian","8""  Raised Bed -4' (8""  Raised Bed - 4')",3,,69.95,209.85,5500.70
,"Invoice","04/30/2020","94","8"" Shelf Bed - 4'","Chris Vivian","8"" Shelf Bed -4' (8"" Shelf Bed - 4')",3,,99.95,299.85,5800.55
,"Invoice","04/30/2020","94","Delivery & Install","Chris Vivian","Install (Delivery & Install)",1,,820.12,820.12,6620.67
,"Invoice","04/30/2020","94","Discount","Chris Vivian","Discount (Discount)","",,-10.00%,-687.10,5933.57
,"Invoice","04/30/2020","94","18"" Ground Anchor","Chris Vivian","Ground Anchors (18"" Ground Anchor)",6,,30.49,182.94,6116.51
,"Invoice","04/30/2020","94","Z Bracket","Chris Vivian","Z Bracket (Z Bracket)",6,,11.23,67.38,6183.89
,"Invoice","05/16/2020","109","8' x 12' Modular Greenhouse","Christopher Learned","8' x 12' Greenhouse (8' x 12' Modular Greenhouse)",1,,3749.00,3749.00,3749.00
,"Invoice","05/16/2020","109","18"" Ground Anchor","Christopher Learned","Ground Anchors (18"" Ground Anchor)",9,,30.49,274.41,4023.41
,"Invoice","05/16/2020","109","Z Bracket","Christopher Learned","Z Bracket (Z Bracket)",9,,11.23,101.07,4124.48
,"Invoice","05/16/2020","109","Automatic Pop Vent","Christopher Learned","Pop Vent (Automatic Pop Vent)",3,"ea",89.00,267.00,4391.48
,"Invoice","05/16/2020","109","Delivery & Install","Christopher Learned","Install (Delivery & Install)",1,,614.8072,614.81,5006.29
,"Invoice","07/29/2020","122","26"" Raised Bed - 4' x 26"" x 24""","Christopher Learned","26""  Raised Bed (26"" Raised Bed)",3,,97.95,293.85,5300.14
,"Invoice","07/29/2020","122","13"" Raised Bed - 4' x 13"" x 24""","Christopher Learned","13"" Raised Bed",3,,69.95,209.85,5509.99
,"Invoice","07/29/2020","122","8"" Shelf Bed - 4' x 8"" x 16""","Christopher Learned","8"" Shelf Bed -4' (8"" Shelf Bed - 4')",3,,99.95,299.85,5809.84
,"Invoice","07/29/2020","122","Electric Swamp Cooler Large","Christopher Learned","Swamp Cooler Large (Electric Swamp Cooler Large)",1,"ea",600.00,600.00,6409.84
,"Invoice","07/29/2020","122","Delivery & Install","Christopher Learned","Install (Delivery & Install)","",,14.00%,196.50,6606.34
,"Invoice","06/28/2019","41","Shade Cover - Green","Cindy & Jim Edwards","Custom Build Accessories",1,,125.00,125.00,125.00
,"Invoice","06/28/2019","41","Solar Fan","Cindy & Jim Edwards","Solar Fan 16""x (Solar Fan)",1,,730.10,730.10,855.10
,"Invoice","06/28/2019","41","Dual Circuit Thermostat","Cindy & Jim Edwards","Thermostatx (Dual Circuit Thermostat)",1,,29.95,29.95,885.05
,"Invoice","06/28/2019","41","12' Shutter Vent","Cindy & Jim Edwards","12' Shutter Vent (12' Shutter Vent)",1,,29.95,29.95,915.00
,"Invoice","06/28/2019","41","Delivery & Install","Cindy & Jim Edwards","Accessory Install (Delivery & Install)",1,,125.00,125.00,1040.00
,"Invoice","10/30/2019","55","8' x 8' Modular Greenhouse","Cindy & Jim McCauley","8' x 8' Greenhouse (8' x 8' Modular Greenhouse)",1,,3199.00,3199.00,3199.00
,"Invoice","10/30/2019","55","Discount","Cindy & Jim McCauley","Discount (Discount)","",,-319.90,-319.90,2879.10
,"Invoice","10/30/2019","55","18' Ground Anchor","Cindy & Jim McCauley","Ground Anchors (18"" Ground Anchor)",7,,30.49,213.43,3092.53
,"Invoice","10/30/2019","55","Z Bracket","Cindy & Jim McCauley","Z Bracket (Z Bracket)",7,,11.23,78.61,3171.14
,"Invoice","10/30/2019","55","Self-opening automatic roof vent","Cindy & Jim McCauley","Automatic Roof Vent (Self-opening automatic roof vent)",2,,65.10,130.20,3301.34
,"Invoice","10/30/2019","55","Univent OT Standard","Cindy & Jim McCauley","Univent OTStandard (Univent OT Standard)",2,,23.90,47.80,3349.14
,"Invoice","10/30/2019","55","Delivery & Install","Cindy & Jim McCauley","Install (Delivery & Install)",1,,560.00,560.00,3909.14
,"Invoice","10/30/2019","55","Electric Swamp Cooler Small","Cindy & Jim McCauley","Swamp Cooler Small (Electric Swamp Cooler Small)",1,"ea",450.00,450.00,4359.14
,"Invoice","04/27/2019","23"," Swamp Cooler","Cindy Greene","Electric Swamp Cooler Largex ( Swamp Cooler)",1,,550.00,550.00,550.00
,"Invoice","04/27/2019","23","Delivery & Install","Cindy Greene","Accessory Install (Delivery & Install)",1,,75.00,75.00,625.00
,"Invoice","04/29/2019","40","4' x 6' x 26"" Raised Bed w/ 34"" Cover","Corrina Avery","4' x 6' x 26"" Raised Beds (4' x 6' x 26"" Raised Bed w/ 66"" Cover)",1,"ea",1857.54,1857.54,1857.54
,"Invoice","04/29/2019","40","Discount  -","Corrina Avery","Discount (Discount)","",,-400.00,-400.00,1457.54
,"Invoice","07/17/2020","120","8' x 16' w/ Side Cathedral Modular Greenhouse","Craig Klose","8' x 16' GH Side Cathedral (8' x 16' w/ Side Cathedral Modular Greenhouse)",1,,5249.00,5249.00,5249.00
,"Invoice","07/17/2020","120","4' Shelf","Craig Klose","4' Shelf (4' Shelf)",2,,74.95,149.90,5398.90
,"Invoice","07/17/2020","120","26"" Raised Bed","Craig Klose","26""  Raised Bed (26"" Raised Bed)",1,,97.95,97.95,5496.85
,"Invoice","07/17/2020","120","8""  Raised Bed - 4'","Craig Klose","8""  Raised Bed -4' (8""  Raised Bed - 4')",1,,69.95,69.95,5566.80
,"Invoice","07/17/2020","120","8"" Shelf Bed - 4'","Craig Klose","8"" Shelf Bed -4' (8"" Shelf Bed - 4')",1,,99.95,99.95,5666.75
,"Invoice","07/17/2020","120","Automatic Pop Vent","Craig Klose","Pop Vent (Automatic Pop Vent)",2,"ea",89.00,178.00,5844.75
,"Invoice","07/17/2020","120","Shipping - BOL 39189777","Craig Klose","Shipping (Shipping)",1,,602.78,602.78,6447.53
,"Invoice","07/17/2020","120","Z Bracket (Anchor Brackets)","Craig Klose","Z Bracket (Z Bracket)",12,,11.23,134.76,6582.29
,"Invoice","02/07/2019","6","8' x 4' Modular Greenhouse - HInge Left","Craig Method","8' x 4' Greenhouse (8' x 4' Modular Greenhouse)",1,,1949.00,1949.00,1949.00
,"Invoice","02/07/2019","6","26' Raised Bed","Craig Method","26""  Raised Bed (26"" Raised Bed)",2,,97.95,195.90,2144.90
,"Invoice","02/07/2019","6","8' Raised Bed - 4'","Craig Method","8""  Raised Bed -4' (8""  Raised Bed - 4')",1,,69.95,69.95,2214.85
,"Invoice","02/07/2019","6","8' Shelf Bed - 4'","Craig Method","8"" Shelf Bed -4' (8"" Shelf Bed - 4')",1,,99.95,99.95,2314.80
,"Invoice","02/07/2019","6","Self-opening automatic roof vent","Craig Method","Automatic Roof Vent (Self-opening automatic roof vent)",1,,65.10,65.10,2379.90
,"Invoice","02/07/2019","6","Univent OT Standard","Craig Method","Univent OTStandard (Univent OT Standard)",1,,23.90,23.90,2403.80
,"Invoice","02/07/2019","6","Delivery & Install 8 x 4","Craig Method","Install 8 x 4 (Delivery & Install 8 x 4)",1,,250.00,250.00,2653.80
,"Invoice","02/07/2019","6","18' Ground Anchor","Craig Method","Ground Anchors (18"" Ground Anchor)",5,,27.88,139.40,2793.20
,"Invoice","02/07/2019","6","Z Bracket","Craig Method","Z Bracket (Z Bracket)",5,,8.70,43.50,2836.70
,"Invoice","02/07/2019","6","Discount 15% Winter Sale & Moana","Craig Method","Discount (Discount)","",,-292.35,-292.35,2544.35
,"Credit Memo","02/07/2019",,"to comp balance","Craig Method","Comp (JS)",-1,,1368.21,-1368.21,1176.14
,"Invoice","03/31/2020","81","8' x 20' w/ Side Cathedral Modular Greenhouse","David Kozicki","8' x 20' GH Side Cathedral (8' x 20' w/ Side Cathedral Modular Greenhouse)",1,,5995.00,5995.00,5995.00
,"Invoice","03/31/2020","81","26"" Raised Bed","David Kozicki","26""  Raised Bed (26"" Raised Bed)",6,,97.95,587.70,6582.70
,"Invoice","03/31/2020","81","8"" Shelf Bed - 4'","David Kozicki","8"" Shelf Bed -4' (8"" Shelf Bed - 4')",2,,99.95,199.90,6782.60
,"Invoice","03/31/2020","81","8""  Raised Bed - 4'","David Kozicki","8""  Raised Bed -4' (8""  Raised Bed - 4')",2,,69.95,139.90,6922.50
,"Invoice","03/31/2020","81","4' Shelf","David Kozicki","4' Shelf (4' Shelf)",1,,74.95,74.95,6997.45
,"Invoice","03/31/2020","81","4' x 2' Work Bench","David Kozicki","4' Work Bench (4' x 2' Work Bench)",1,"ea",55.00,55.00,7052.45
,"Invoice","03/31/2020","81","Automatic Pop Vent","David Kozicki","Pop Vent (Automatic Pop Vent)",6,"ea",89.00,534.00,7586.45
,"Invoice","03/31/2020","81"," Swamp Cooler w/ thermostat","David Kozicki","Electric Swamp Cooler Largex ( Swamp Cooler)",1,,589.00,589.00,8175.45
,"Invoice","03/31/2020","81","18"" Ground Anchor","David Kozicki","Ground Anchors (18"" Ground Anchor)",1,,30.49,30.49,8205.94
,"Invoice","03/31/2020","81","Z Bracket","David Kozicki","Z Bracket (Z Bracket)",1,,11.23,11.23,8217.17
,"Invoice","03/31/2020","81",,"David Kozicki","Shipping/Delivery",1,,708.525,708.53,8925.70
,"Invoice","05/04/2020","95","8' x 20' Greenhouse w/ 4' Pop-out","David Ritchie","8'x20' Greenhouse w/ 4' Pop-out (8' x 20' Greenhouse w/ 4' Pop-out)",1,,6749.00,6749.00,6749.00
,"Invoice","05/04/2020","95","Wind/Snow Package","David Ritchie","Wind/Snow Package (Wind/Snow Package)",5,,74.95,374.75,7123.75
,"Invoice","05/04/2020","95","26"" Raised Bed","David Ritchie","26""  Raised Bed (26"" Raised Bed)",5,,97.95,489.75,7613.50
,"Invoice","05/04/2020","95","8""  Raised Bed - 4'","David Ritchie","8""  Raised Bed -4' (8""  Raised Bed - 4')",3,,69.95,209.85,7823.35
,"Invoice","05/04/2020","95","8"" Shelf Bed - 4'","David Ritchie","8"" Shelf Bed -4' (8"" Shelf Bed - 4')",4,,99.95,399.80,8223.15
,"Invoice","05/04/2020","95","Automatic Pop Vent","David Ritchie","Pop Vent (Automatic Pop Vent)",6,"ea",89.00,534.00,8757.15
,"Invoice","05/04/2020","95","Electric Swamp Cooler Large","David Ritchie","Swamp Cooler Large (Electric Swamp Cooler Large)",1,"ea",600.00,600.00,9357.15
,"Invoice","05/04/2020","95","Delivery & Install","David Ritchie","Shipping CA (Shipping CA)",1,,1500.00,1500.00,10857.15
,"Invoice","05/04/2020","95","Additional $100 for every 25 miles outside Reno/Sparks","David Ritchie","Additional Delivery Fee (Additional $100 for every 25 miles outside Reno/Sparks)",1,,100.00,100.00,10957.15
,"Invoice","05/04/2020","95","Smart Technology - Beta Testing Kit *** To be installed and billed at a later date - $900","David Ritchie","Smart Technology (Smart Technology - Custom)",1,,0.00,0.00,10957.15
,"Invoice","05/04/2020","95","Drain Trays - Custom","David Ritchie","Drain Trays (Drain Trays)",4,,89.95,359.80,11316.95
,"Invoice","05/04/2020","95","18"" Ground Anchor","David Ritchie","Ground Anchors (18"" Ground Anchor)",10,,30.49,304.90,11621.85
,"Invoice","05/04/2020","95","Z Bracket","David Ritchie","Z Bracket (Z Bracket)",10,,11.23,112.30,11734.15
,"Invoice","05/04/2020","95","4"" Concrete Tapcons","David Ritchie","Anchors - Concrete (4"" Concrete Tapcons)",12,"ea",2.00,24.00,11758.15
,"Invoice","05/04/2020","95","Delivery & Install","David Ritchie","Install (Delivery & Install)",1,,50.37,50.37,11808.52
,"Invoice","11/13/2019","58","8' x 20' Greenhouse w/ 4' Pop-out","Dawn Rickabaugh","8'x20' Greenhouse w/ 4' Pop-out (8' x 20' Greenhouse w/ 4' Pop-out)",1,,6749.00,6749.00,6749.00
,"Invoice","11/13/2019","58","18' Ground Anchor","Dawn Rickabaugh","Ground Anchors (18"" Ground Anchor)",17,,30.49,518.33,7267.33
,"Invoice","11/13/2019","58","Z Bracket","Dawn Rickabaugh","Z Bracket (Z Bracket)",17,,11.23,190.91,7458.24
,"Invoice","11/13/2019","58","Self-opening automatic roof vent","Dawn Rickabaugh","Automatic Roof Vent (Self-opening automatic roof vent)",7,,65.10,455.70,7913.94
,"Invoice","11/13/2019","58","Univent OT Standard","Dawn Rickabaugh","Univent OTStandard (Univent OT Standard)",7,,23.90,167.30,8081.24
,"Invoice","11/13/2019","58","24' Raised Bed","Dawn Rickabaugh","24'  Raised Bed (24' Raised Bed)",5,,97.95,489.75,8570.99
,"Invoice","11/13/2019","58","8""  Raised Bed - 4'","Dawn Rickabaugh","8""  Raised Bed -4' (8""  Raised Bed - 4')",4,,69.95,279.80,8850.79
,"Invoice","11/13/2019","58","8"" Shelf Bed - 4'","Dawn Rickabaugh","8"" Shelf Bed -4' (8"" Shelf Bed - 4')",4,,99.95,399.80,9250.59
,"Invoice","11/13/2019","58","4' Shelf","Dawn Rickabaugh","4' Shelf (4' Shelf)",1,,74.95,74.95,9325.54
,"Invoice","11/13/2019","58"," Swamp Cooler","Dawn Rickabaugh","Electric Swamp Cooler Largex ( Swamp Cooler)",1,,469.00,469.00,9794.54
,"Invoice","11/13/2019","58","Ground Fencing","Dawn Rickabaugh","Ground Fencingx (Ground fencing under entire greenhouse)",1,,150.00,150.00,9944.54
,"Invoice","11/13/2019","58","Delivery Only","Dawn Rickabaugh","Additional Delivery Fee (Additional $100 for every 25 miles outside Reno/Sparks)",1,,150.00,150.00,10094.54
,"Invoice","05/13/2020","102","8' x 4' Addition to current GH","Dawn Rickabaugh","8' x 4'   Addition (8' x 4' Addition to current GH)",1,,750.00,750.00,10844.54
,"Invoice","05/13/2020","102","18"" Ground Anchor","Dawn Rickabaugh","Ground Anchors (18"" Ground Anchor)",2,,30.49,60.98,10905.52
,"Invoice","05/13/2020","102","Z Bracket","Dawn Rickabaugh","Z Bracket (Z Bracket)",2,,11.23,22.46,10927.98
,"Invoice","05/13/2020","102","26"" Raised Bed","Dawn Rickabaugh","26""  Raised Bed (26"" Raised Bed)",1,,97.95,97.95,11025.93
,"Invoice","05/13/2020","102","8"" Shelf Bed - 4'","Dawn Rickabaugh","8"" Shelf Bed -4' (8"" Shelf Bed - 4')",1,,99.95,99.95,11125.88
,"Invoice","05/13/2020","102","8""  Raised Bed - 4'","Dawn Rickabaugh","8""  Raised Bed -4' (8""  Raised Bed - 4')",1,,69.95,69.95,11195.83
,"Invoice","05/13/2020","102","Delivery & Install","Dawn Rickabaugh","Install (Delivery & Install)",1,,155.00,155.00,11350.83
,"Invoice","05/13/2020","102","Additional $100 for every 25 miles outside Reno/Sparks","Dawn Rickabaugh","Additional Delivery Fee (Additional $100 for every 25 miles outside Reno/Sparks)",1,,100.00,100.00,11450.83
,"Invoice","09/13/2019","53","8' x 4' Addition to current GH","Debbie Rossi","8' x 4'   Addition (8' x 4' Addition to current GH)",2,,750.00,1500.00,1500.00
,"Invoice","09/13/2019","53","Additional Door w/ Dormer","Debbie Rossi","Additional Door (Additional Door)",1,,1500.00,1500.00,3000.00
,"Invoice","09/13/2019","53","Discount 5%","Debbie Rossi","Discount (Discount)","",,-150.00,-150.00,2850.00
,"Invoice","09/13/2019","53","Self-opening automatic roof vent","Debbie Rossi","Automatic Roof Vent (Self-opening automatic roof vent)",1,,65.10,65.10,2915.10
,"Invoice","09/13/2019","53","Univent OT Standard","Debbie Rossi","Univent OTStandard (Univent OT Standard)",1,,23.90,23.90,2939.00
,"Invoice","09/13/2019","53","18' Ground Anchor","Debbie Rossi","Ground Anchors (18"" Ground Anchor)",4,,30.49,121.96,3060.96
,"Invoice","09/13/2019","53","Z Bracket","Debbie Rossi","Z Bracket (Z Bracket)",4,,11.23,44.92,3105.88
,"Invoice","09/13/2019","53","Delivery & Install","Debbie Rossi","Install (Delivery & Install)",1,,435.00,435.00,3540.88
,"Invoice","02/25/2020","73","8' x 20' Greenhouse w/ 4' Pop-out","Dell Aguilar","8'x20' Greenhouse w/ 4' Pop-out (8' x 20' Greenhouse w/ 4' Pop-out)",1,,6749.00,6749.00,6749.00
,"Invoice","02/25/2020","73","4' x 26"" Tall Raised Bed","Dell Aguilar","26""  Raised Bed (26"" Raised Bed)",7,,97.95,685.65,7434.65
,"Invoice","02/25/2020","73","4' x 6' x 26"" Raised Bed","Dell Aguilar","4' x 6' x 26""   Raised Bed (4' x 6' x 26""Raised Bed)",2,"ea",269.00,538.00,7972.65
,"Invoice","02/25/2020","73","4' x 8"" Deep Shelf Bed","Dell Aguilar","8"" Shelf Bed -4' (8"" Shelf Bed - 4')",2,,99.95,199.90,8172.55
,"Invoice","02/25/2020","73","4' x 8""  Raised Bed (below shelf bed)","Dell Aguilar","8""  Raised Bed -4' (8""  Raised Bed - 4')",2,,69.95,139.90,8312.45
,"Invoice","02/25/2020","73","26"" Ground Anchors","Dell Aguilar","Ground Anchors - 26"" (26"" Ground Anchors)",15,,47.00,705.00,9017.45
,"Invoice","02/25/2020","73","Z Bracket","Dell Aguilar","Z Bracket (Z Bracket)",15,,11.23,168.45,9185.90
,"Invoice","02/25/2020","73","Automatic Pop Vent","Dell Aguilar","Pop Vent (Automatic Pop Vent)",5,"ea",89.00,445.00,9630.90
,"Invoice","02/25/2020","73"," Swamp Cooler","Dell Aguilar","Electric Swamp Cooler Largex ( Swamp Cooler)",1,,600.00,600.00,10230.90
,"Invoice","02/25/2020","73","Delivery & Install","Dell Aguilar","Install (Delivery & Install)",1,,1290.52,1290.52,11521.42
,"Invoice","02/25/2020","73","18% Discount per Josh","Dell Aguilar","Discount (Discount)","",,-20.00%,-2304.28,9217.14
,"Invoice","03/10/2020","74","8' x 12' Modular Greenhouse","Denton Hathaway","8' x 12' Greenhouse (8' x 12' Modular Greenhouse)",1,,3749.00,3749.00,3749.00
,"Invoice","03/10/2020","74","15% Dealer Discount","Denton Hathaway","15% Dealer Discount (15% Dealer Discount)","",,-562.35,-562.35,3186.65
,"Invoice","03/10/2020","74","Automatic Pop Vent","Denton Hathaway","Pop Vent (Automatic Pop Vent)",3,"ea",89.00,267.00,3453.65
,"Invoice","03/10/2020","74","18"" Ground Anchor","Denton Hathaway","Ground Anchors (18"" Ground Anchor)",9,,34.49,310.41,3764.06
,"Invoice","03/10/2020","74","Z Bracket","Denton Hathaway","Z Bracket (Z Bracket)",9,,11.23,101.07,3865.13
,"Invoice","03/10/2020","74","Custom Trim (chrome)","Denton Hathaway","Diamond Plate Trim (Custom Trim)",1,"ea",200.00,200.00,4065.13
,"Invoice","03/10/2020","74","Delivery & Install","Denton Hathaway","Install (Delivery & Install)",1,,610.65,610.65,4675.78
,"Invoice","03/09/2020","80","8' x 16' Greenhouse w/ 4' Pop-out","Diane Hawhee","8'x16' Greenhouse w/ 4' Pop-out (8' x 16' Greenhouse w/ 4' Pop-out)",1,,5995.00,5995.00,5995.00
,"Invoice","03/09/2020","80","Automatic Pop Vent","Diane Hawhee","Pop Vent (Automatic Pop Vent)",5,"ea",89.00,445.00,6440.00
,"Invoice","03/09/2020","80","Wind/Snow Package","Diane Hawhee","Wind/Snow Package (Wind/Snow Package)",3,,96.00,288.00,6728.00
,"Invoice","03/09/2020","80","26"" Raised Bed","Diane Hawhee","26""  Raised Bed (26"" Raised Bed)",4,,97.95,391.80,7119.80
,"Invoice","03/09/2020","80","8"" Shelf Bed - 4'","Diane Hawhee","8"" Shelf Bed -4' (8"" Shelf Bed - 4')",2,,99.95,199.90,7319.70
,"Invoice","03/09/2020","80","8""  Raised Bed - 4'","Diane Hawhee","8""  Raised Bed -4' (8""  Raised Bed - 4')",2,,69.95,139.90,7459.60
,"Invoice","03/09/2020","80","4' Shelf","Diane Hawhee","4' Shelf (4' Shelf)",1,,74.95,74.95,7534.55
,"Invoice","03/09/2020","80","18"" Ground Anchor","Diane Hawhee","Ground Anchors (18"" Ground Anchor)",9,,30.49,274.41,7808.96
,"Invoice","03/09/2020","80","Z Bracket","Diane Hawhee","Z Bracket (Z Bracket)",9,,11.23,101.07,7910.03
,"Invoice","03/09/2020","80","Solar Fan","Diane Hawhee","Solar Fan 16""x (Solar Fan)",1,,620.10,620.10,8530.13
,"Invoice","03/09/2020","80","Dual Circuit Thermostat","Diane Hawhee","Thermostatx (Dual Circuit Thermostat)",1,,29.95,29.95,8560.08
,"Invoice","03/09/2020","80",,"Diane Hawhee","Shipping/Delivery",1,,1306.06,1306.06,9866.14
,"Invoice","03/09/2020","80","Sales Discount 5%","Diane Hawhee","5% Sales Discount (Sales Discount 5%)","",,-5.00%,-493.31,9372.83
,"Invoice","08/28/2019","47","4' x 6' x 26"" Raised Bed w/ 66"" Cover","Dianne Kennedy","4' x 6' x 26"" Raised Beds (4' x 6' x 26"" Raised Bed w/ 66"" Cover)",1,"ea",1489.00,1489.00,1489.00
,"Invoice","08/28/2019","47","Discount - per Josh","Dianne Kennedy","Discount (Discount)","",,-488.20,-488.20,1000.80
,"Invoice","08/28/2019","47","Raised Bed Delivery","Dianne Kennedy","Raised Bed Delivery (Raised Bed Delivery)",1,,75.00,75.00,1075.80
,"Invoice","08/08/2019","44","Over Stair Structure - updated to roof Covering only  & window Cover","Dru Reflections","Custom Build Accessories",1,,635.00,635.00,635.00
,"Invoice","08/08/2019","44","Delivery & Install","Dru Reflections","Install (Delivery & Install)",1,,92.00,92.00,727.00
,"Invoice","01/15/2020","63","45"" x 59 "" Clear acrylic side panel for walkway cover","Dru Reflections","Custom Build Accessories",1,,250.00,250.00,977.00
,"Invoice","01/15/2020","63","Delivery & Install","Dru Reflections","Accessory Install (Delivery & Install)",1,,99.75,99.75,1076.75
,"Invoice","03/18/2019","13","Falcon Model 4' x 4' x 26"" Raised w/ Auto Pop up vent","Dwight Longaker","Falcon Model (Falcon Model 4' x 4' x 26"" Raised bed & Cover w/ Auto Pop up vent)",1,"ea",999.00,999.00,999.00
,"Invoice","03/18/2019","13","Discount Reno Home & Garden Show","Dwight Longaker","Discount (Discount)","",,-250.47,-250.47,748.53
,"Invoice","03/18/2019","13","Raided Bed Delivery","Dwight Longaker","Raised Bed Delivery (Raised Bed Delivery)",1,,75.00,75.00,823.53
,"Invoice","03/18/2019","13","Discount Raised Bed","Dwight Longaker","Discount (Discount)","",,-75.00,-75.00,748.53
,"Invoice","07/25/2020","123","8' x 8' Modular Greenhouse","Ellen and Bob Beebe","8' x 8' Greenhouse (8' x 8' Modular Greenhouse)",1,,3199.00,3199.00,3199.00
,"Invoice","07/25/2020","123","Automatic Pop Vent","Ellen and Bob Beebe","Pop Vent (Automatic Pop Vent)",2,"ea",89.00,178.00,3377.00
,"Invoice","07/25/2020","123","Electric Swamp Cooler Small","Ellen and Bob Beebe","Swamp Cooler Small (Electric Swamp Cooler Small)",1,"ea",450.00,450.00,3827.00
,"Invoice","07/25/2020","123","26"" Raised Bed","Ellen and Bob Beebe","26""  Raised Bed (26"" Raised Bed)",3,,97.95,293.85,4120.85
,"Invoice","07/25/2020","123","13"" Raised Bed (48"" L x 24"" W x 13"" H)","Ellen and Bob Beebe","13"" Raised Bed",1,,69.95,69.95,4190.80
,"Invoice","07/25/2020","123","8"" Shelf Bed - 4' - Half Shelf 12"" Depth (48"" L x 16"" W x 8"" H)   *Chains and bracing included i...","Ellen and Bob Beebe","8"" Shelf Bed -4' (8"" Shelf Bed - 4')",1,,99.95,99.95,4290.75
,"Invoice","07/25/2020","123","4' Shelf (48"" L x 24"" W)","Ellen and Bob Beebe","4' Shelf (4' Shelf)",1,,74.95,74.95,4365.70
,"Invoice","07/25/2020","123","18"" Ground Anchor","Ellen and Bob Beebe","Ground Anchors (18"" Ground Anchor)",5,,30.49,152.45,4518.15
,"Invoice","07/25/2020","123","Z Bracket","Ellen and Bob Beebe","Z Bracket (Z Bracket)",5,,11.23,56.15,4574.30
,"Invoice","07/25/2020","123","Sales Discount 5% - Moana Nursery Discount per Brittany","Ellen and Bob Beebe","5% Sales Discount (Sales Discount 5%)","",,-5.00%,-228.72,4345.58
,"Invoice","07/25/2020","123","Delivery & Install","Ellen and Bob Beebe","Install (Delivery & Install)","",,14.00%,608.38,4953.96
,"Invoice","07/12/2019","36","8' x 24' w/ Side Cathedral Modular Greenhouse","Elsa Corrigan","8' x 24' GH Side Cathedral (8' x 24' w/ Side Cathedral Modular Greenhouse)",1,,6749.00,6749.00,6749.00
,"Invoice","07/12/2019","36","8mm Polycarb Upgrade","Elsa Corrigan","8mm Polycarb Upgrade (8mm Polycarb Upgrade)",1,,674.90,674.90,7423.90
,"Invoice","07/12/2019","36","Discount - Moana","Elsa Corrigan","Discount (Discount)","",,-372.00,-372.00,7051.90
,"Invoice","07/12/2019","36","Self-opening automatic roof vent","Elsa Corrigan","Automatic Roof Vent (Self-opening automatic roof vent)",8,,65.10,520.80,7572.70
,"Invoice","07/12/2019","36","Univent OT Standard","Elsa Corrigan","Univent OTStandard (Univent OT Standard)",8,,23.90,191.20,7763.90
,"Invoice","07/12/2019","36","26' Raised Bed","Elsa Corrigan","26""  Raised Bed (26"" Raised Bed)",6,,97.95,587.70,8351.60
,"Invoice","07/12/2019","36","18' Ground Anchor","Elsa Corrigan","Ground Anchors (18"" Ground Anchor)",15,,30.49,457.35,8808.95
,"Invoice","07/12/2019","36","Z Bracket","Elsa Corrigan","Z Bracket (Z Bracket)",15,,11.23,168.45,8977.40
,"Invoice","07/12/2019","36","Wind/Snow Package","Elsa Corrigan","Wind/Snow Package (Wind/Snow Package)",1,,350.00,350.00,9327.40
,"Invoice","07/12/2019","36","Shipping CA","Elsa Corrigan","Shipping CA (Shipping CA)",1,,1200.54,1200.54,10527.94
,"Invoice","07/12/2019","36","8' Raised Bed - 4'","Elsa Corrigan","8""  Raised Bed -4' (8""  Raised Bed - 4')",3,,69.95,209.85,10737.79
,"Invoice","07/12/2019","36","8' Shelf Bed - 4'","Elsa Corrigan","8"" Shelf Bed -4' (8"" Shelf Bed - 4')",3,,99.95,299.85,11037.64
,"Invoice","07/12/2019","36","Water Tank 275 Gal","Elsa Corrigan","Water Tank 275 gal (Water Tank 275 Gal)",1,,225.00,225.00,11262.64
,"Invoice","07/12/2019","36","4' Shelf","Elsa Corrigan","4' Shelf (4' Shelf)",1,,74.95,74.95,11337.59
,"Invoice","07/12/2019","36","Solar Fan","Elsa Corrigan","Solar Fan 20"" (Solar Fan)",1,,750.10,750.10,12087.69
,"Invoice","06/29/2020","116","8' x 24' w/ Side Cathedral Modular Greenhouse","Elsa Corrigan","8' x 24' GH Side Cathedral (8' x 24' w/ Side Cathedral Modular Greenhouse)",1,,6749.00,6749.00,18836.69
,"Invoice","06/29/2020","116","8mm Polycarb Upgrade","Elsa Corrigan","8mm Polycarb Upgrade (8mm Polycarb Upgrade)",1,,674.00,674.00,19510.69
,"Invoice","06/29/2020","116","Discount - Moana 5% Discount per Josh 5%","Elsa Corrigan","Discount (Discount)","",,-674.90,-674.90,18835.79
,"Invoice","06/29/2020","116","Automatic Pop Vent","Elsa Corrigan","Pop Vent (Automatic Pop Vent)",6,"ea",89.00,534.00,19369.79
,"Invoice","06/29/2020","116","26"" Raised Bed","Elsa Corrigan","26""  Raised Bed (26"" Raised Bed)",4,,97.95,391.80,19761.59
,"Invoice","06/29/2020","116","18"" Ground Anchor","Elsa Corrigan","Ground Anchors (18"" Ground Anchor)",15,,30.49,457.35,20218.94
,"Invoice","06/29/2020","116","Z Bracket","Elsa Corrigan","Z Bracket (Z Bracket)",15,,11.23,168.45,20387.39
,"Invoice","06/29/2020","116","Wind/Snow Package","Elsa Corrigan","Wind/Snow Package (Wind/Snow Package)",6,,79.00,474.00,20861.39
,"Invoice","06/29/2020","116","8""  Raised Bed - 4'","Elsa Corrigan","8""  Raised Bed -4' (8""  Raised Bed - 4')",4,,69.95,279.80,21141.19
,"Invoice","06/29/2020","116","8"" Shelf Bed - 4'","Elsa Corrigan","8"" Shelf Bed -4' (8"" Shelf Bed - 4')",4,,99.95,399.80,21540.99
,"Invoice","06/29/2020","116","Water Tank 275 Gal","Elsa Corrigan","Water Tank 275 gal (Water Tank 275 Gal)",1,,225.00,225.00,21765.99
,"Invoice","06/29/2020","116","4' Shelf","Elsa Corrigan","4' Shelf (4' Shelf)",1,,74.95,74.95,21840.94
,"Invoice","06/29/2020","116","Solar Fan 20ï¿½","Elsa Corrigan","Solar Fan 20ï¿½ (Solar Fan 20ï¿½)",1,"ea",750.10,750.10,22591.04
,"Invoice","06/29/2020","116","Delivery & Install","Elsa Corrigan","Shipping CA (Shipping CA)",1,,1520.00,1520.00,24111.04
,"Invoice","06/29/2020","116","Additional $100 for every 25 miles outside Reno/Sparks","Elsa Corrigan","Additional Delivery Fee (Additional $100 for every 25 miles outside Reno/Sparks)",1,,100.00,100.00,24211.04
,"Invoice","06/29/2020","116","Discount- 10% Customer Loyalty Discount per Josh","Elsa Corrigan","Discount (Discount)","",,-1216.935,-1216.94,22994.10
,"Invoice","08/14/2020","128","Automatic Pop Vent","Elsa Corrigan","Pop Vent (Automatic Pop Vent)",2,"ea",89.00,178.00,23172.10
,"Invoice","08/14/2020","128","Solar Fan 16ï¿½","Elsa Corrigan","Solar Fan 16ï¿½ (Solar Fan 16ï¿½)",1,"ea",620.20,620.20,23792.30
,"Invoice","08/14/2020","128","Delivery & Install","Elsa Corrigan","Install (Delivery & Install)",1,,111.75,111.75,23904.05
,"Invoice","08/10/2020","125","8' x 16' Modular Greenhouse","Frank Bursinger","8' x 16' Greenhouse (8' x 16' Modular Greenhouse)",1,,4495.00,4495.00,4495.00
,"Invoice","08/10/2020","125","18"" Ground Anchor","Frank Bursinger","Ground Anchors (18"" Ground Anchor)",11,,30.49,335.39,4830.39
,"Invoice","08/10/2020","125","Z Bracket","Frank Bursinger","Z Bracket (Z Bracket)",11,,11.23,123.53,4953.92
,"Invoice","08/10/2020","125","Automatic Pop Vent","Frank Bursinger","Pop Vent (Automatic Pop Vent)",4,"ea",89.00,356.00,5309.92
,"Invoice","08/10/2020","125","26"" Raised Bed","Frank Bursinger","26""  Raised Bed (26"" Raised Bed)",4,,97.95,391.80,5701.72
,"Invoice","08/10/2020","125","4' Shelf","Frank Bursinger","4' Shelf (4' Shelf)",1,,74.95,74.95,5776.67
,"Invoice","03/04/2019","18","8' x 20' Greenhouse w/ 4' Pop-out - (Demo)","Gail Willey","8'x20' Greenhouse w/ 4' Pop-out (8' x 20' Greenhouse w/ 4' Pop-out)",1,,5965.00,5965.00,5965.00
,"Invoice","03/04/2019","18","18' Ground Anchor","Gail Willey","Ground Anchors (18"" Ground Anchor)",15,,27.88,418.20,6383.20
,"Invoice","03/04/2019","18","Z Bracket","Gail Willey","Z Bracket (Z Bracket)",15,,8.70,130.50,6513.70
,"Invoice","03/04/2019","18","Self-opening automatic roof vent","Gail Willey","Automatic Roof Vent (Self-opening automatic roof vent)",4,,65.10,260.40,6774.10
,"Invoice","03/04/2019","18","Univent OT Standard","Gail Willey","Univent OTStandard (Univent OT Standard)",4,,23.90,95.60,6869.70
,"Invoice","03/04/2019","18","Discount  25% Per Josh","Gail Willey","Discount (Discount)","",,-1933.00,-1933.00,4936.70
,"Invoice","03/04/2019","18","Delivery & Install 8 x 24","Gail Willey","Install 8 x 24 (Delivery & Install 8 x 24)",1,,500.00,500.00,5436.70
,"Invoice","03/04/2019","18","Discount Delivery Free","Gail Willey","Discount (Discount)","",,-500.00,-500.00,4936.70
,"Invoice","05/28/2019","31"," Swamp Cooler","Gail Willey","Electric Swamp Cooler Largex ( Swamp Cooler)",1,,550.00,550.00,5486.70
,"Invoice","05/28/2019","31","Discount - 25%","Gail Willey","Discount (Discount)","",,-137.50,-137.50,5349.20
,"Invoice","04/01/2019","19","8' x 16' Greenhouse w/ 4' Pop-out","Gary Mack","8'x16' Greenhouse w/ 4' Pop-out (8' x 16' Greenhouse w/ 4' Pop-out)",1,,5495.00,5495.00,5495.00
,"Invoice","04/01/2019","19","Self-opening automatic roof vent","Gary Mack","Automatic Roof Vent (Self-opening automatic roof vent)",6,,65.10,390.60,5885.60
,"Invoice","04/01/2019","19","Univent OT Standard","Gary Mack","Univent OTStandard (Univent OT Standard)",6,,23.90,143.40,6029.00
,"Invoice","04/01/2019","19","4' Shelf","Gary Mack","4' Shelf (4' Shelf)",4,,74.95,299.80,6328.80
,"Invoice","04/01/2019","19","26' Raised Bed","Gary Mack","26""  Raised Bed (26"" Raised Bed)",2,,97.95,195.90,6524.70
,"Invoice","04/01/2019","19","Discount 10% Reno Home Show","Gary Mack","Discount (Discount)","",,-706.40,-706.40,5818.30
,"Invoice","06/07/2019","32","8' x 16' Modular Greenhouse","George Howard","8' x 16' Greenhouse (8' x 16' Modular Greenhouse)",1,,4495.00,4495.00,4495.00
,"Invoice","06/07/2019","32","Discount","George Howard","Discount (Discount)","",,-713.34,-713.34,3781.66
,"Invoice","06/07/2019","32","Self-opening automatic roof vent","George Howard","Automatic Roof Vent (Self-opening automatic roof vent)",2,,65.10,130.20,3911.86
,"Invoice","06/07/2019","32","Univent OT Standard","George Howard","Univent OTStandard (Univent OT Standard)",2,,23.90,47.80,3959.66
,"Invoice","06/07/2019","32","4' Shelf","George Howard","4' Shelf (4' Shelf)",7,,74.95,524.65,4484.31
,"Invoice","06/07/2019","32",,"George Howard","Concrete  Anchors",1,,129.87,129.87,4614.18
,"Invoice","06/07/2019","32","Delivery & Install","George Howard","Install (Delivery & Install)",1,,625.00,625.00,5239.18
,"Invoice","06/07/2019","32","Discount","George Howard","Discount (Discount)","",,-200.00,-200.00,5039.18
,"Invoice","06/07/2019","32","8' Shelf Bed - 4'","George Howard","8"" Shelf Bed -4' (8"" Shelf Bed - 4')",2,,99.95,199.90,5239.08
,"Invoice","05/28/2019","39","4' x 3' x 26"" Raised Bed w/ 24"" Cover","Greg Juhl","4' x 3' x 26"" Raised Bed (4' x 3' x 26"" Raised Bed w/ 24"" Cover)",1,"ea",349.00,349.00,349.00
,"Invoice","02/27/2020","71","8' x 20' Greenhouse w/ 4' Pop-out","Hagen Strauss","8'x20' Greenhouse w/ 4' Pop-out (8' x 20' Greenhouse w/ 4' Pop-out)",1,,6749.00,6749.00,6749.00
,"Invoice","02/27/2020","71","26"" Raised Bed","Hagen Strauss","26""  Raised Bed (26"" Raised Bed)",6,,97.95,587.70,7336.70
,"Invoice","02/27/2020","71","Automatic Pop Vent","Hagen Strauss","Pop Vent (Automatic Pop Vent)",6,"ea",89.00,534.00,7870.70
,"Invoice","02/27/2020","71","8""  Raised Bed - 4'","Hagen Strauss","8""  Raised Bed -4' (8""  Raised Bed - 4')",3,,69.95,209.85,8080.55
,"Invoice","02/27/2020","71","8"" Shelf Bed - 4'","Hagen Strauss","8"" Shelf Bed -4' (8"" Shelf Bed - 4')",3,,99.95,299.85,8380.40
,"Invoice","02/27/2020","71","4' x 2' Work Bench","Hagen Strauss","4' Work Bench (4' x 2' Work Bench)",1,"ea",55.00,55.00,8435.40
,"Invoice","02/27/2020","71","18"" Ground Anchor","Hagen Strauss","Ground Anchors (18"" Ground Anchor)",15,,33.49,502.35,8937.75
,"Invoice","02/27/2020","71","Z Bracket","Hagen Strauss","Z Bracket (Z Bracket)",15,,11.23,168.45,9106.20
,"Invoice","02/27/2020","71"," Swamp Cooler","Hagen Strauss","Electric Swamp Cooler Largex ( Swamp Cooler)",1,,589.00,589.00,9695.20
,"Invoice","02/27/2020","71","Ground fencing under entire greenhouse","Hagen Strauss","Ground Fencingx (Ground fencing under entire greenhouse)",24,"yd",6.00,144.00,9839.20
,"Invoice","02/27/2020","71","Delivery & Install","Hagen Strauss","Install (Delivery & Install)",1,,1273.95,1273.95,11113.15
,"Invoice","02/27/2020","71","Additional $100 for every 25 miles outside Reno/Sparks","Hagen Strauss","Additional Delivery Fee (Additional $100 for every 25 miles outside Reno/Sparks)",2,,100.00,200.00,11313.15
,"Invoice","04/10/2019","20","8' x 20' Modular Greenhouse","Heather Leutzinger","8'x20' Modular Greenhouse (8' x 20' Modular Greenhouse)",1,,4685.00,4685.00,4685.00
,"Invoice","04/10/2019","20"," Discount - Rail City flyer $ 4495","Heather Leutzinger","Discount (Discount)","",,-190.00,-190.00,4495.00
,"Invoice","04/10/2019","20","18' Ground Anchor","Heather Leutzinger","Ground Anchors (18"" Ground Anchor)",13,,27.88,362.44,4857.44
,"Invoice","04/10/2019","20","Z Bracket","Heather Leutzinger","Z Bracket (Z Bracket)",13,,8.70,113.10,4970.54
,"Invoice","04/10/2019","20","Additional Door","Heather Leutzinger","Additional Door (Additional Door)",1,,350.00,350.00,5320.54
,"Invoice","04/10/2019","20","Discount","Heather Leutzinger","Discount (Discount)","",,-50.00,-50.00,5270.54
,"Invoice","04/10/2019","20","Self-opening automatic roof vent","Heather Leutzinger","Automatic Roof Vent (Self-opening automatic roof vent)",2,,65.10,130.20,5400.74
,"Invoice","04/10/2019","20","Univent OT Standard","Heather Leutzinger","Univent OTStandard (Univent OT Standard)",2,,23.90,47.80,5448.54
,"Invoice","04/10/2019",,"to adjust for over-payment","Heather Leutzinger","Square fee adjustment",1,,0.12,0.12,5448.66
,"Invoice","02/03/2020","66","8' x 16' Modular Greenhouse","Hope Thompson & Jerry Alged","8' x 16' Greenhouse (8' x 16' Modular Greenhouse)",1,,4495.00,4495.00,4495.00
,"Invoice","02/03/2020","66","Discount 10%","Hope Thompson & Jerry Alged","Discount (Discount)","",,-449.50,-449.50,4045.50
,"Invoice","02/03/2020","66","18' Ground Anchor","Hope Thompson & Jerry Alged","Ground Anchors (18"" Ground Anchor)",11,,30.49,335.39,4380.89
,"Invoice","02/03/2020","66","Z Bracket","Hope Thompson & Jerry Alged","Z Bracket (Z Bracket)",11,,11.23,123.53,4504.42
,"Invoice","02/03/2020","66","Self-opening automatic roof vent","Hope Thompson & Jerry Alged","Automatic Roof Vent (Self-opening automatic roof vent)",6,,65.10,390.60,4895.02
,"Invoice","02/03/2020","66","Univent OT Standard","Hope Thompson & Jerry Alged","Univent OTStandard (Univent OT Standard)",6,,23.90,143.40,5038.42
,"Invoice","02/03/2020","66","18' 110v Electric Fan w/ Shutters","Hope Thompson & Jerry Alged","18"" Shutter Fan18A (18"" 110v Electric Fan w/ Shutters)",1,,139.23,139.23,5177.65
,"Invoice","02/03/2020","66","Dual Circuit Thermostat","Hope Thompson & Jerry Alged","Thermostatx (Dual Circuit Thermostat)",1,,29.95,29.95,5207.60
,"Invoice","02/03/2020","66","Delivery & Install","Hope Thompson & Jerry Alged","Install (Delivery & Install)",1,,850.00,850.00,6057.60
,"Invoice","02/03/2020","66","Additional Door","Hope Thompson & Jerry Alged","Additional Door (Additional Door)",1,,350.00,350.00,6407.60
,"Invoice","06/27/2019","38","Self-opening automatic roof vent","Jacob Saeedi","Automatic Roof Vent (Self-opening automatic roof vent)",1,,65.10,65.10,65.10
,"Invoice","06/27/2019","38","Univent OT Standard","Jacob Saeedi","Univent OTStandard (Univent OT Standard)",1,,23.90,23.90,89.00
,"Invoice","06/27/2019","38","12' 110v Electric Fan w/ Shutters","Jacob Saeedi","12"" Shutter Fan12A (12"" 110v Electric Fan w/ Shutters)",1,,169.00,169.00,258.00
,"Invoice","06/27/2019","38","Dual Circuit Thermostat","Jacob Saeedi","Thermostatx (Dual Circuit Thermostat)",1,,29.95,29.95,287.95
,"Invoice","06/27/2019","38","12' Shutter Vent","Jacob Saeedi","12' Shutter Vent (12' Shutter Vent)",1,,29.95,29.95,317.90
,"Invoice","06/27/2019","38","Delivery & Install","Jacob Saeedi","Accessory Install (Delivery & Install)",1,,75.00,75.00,392.90
,"Invoice","02/05/2020","67","8' x 8' Modular Greenhouse","Jean Allen","8' x 8' Greenhouse (8' x 8' Modular Greenhouse)",1,,3199.00,3199.00,3199.00
,"Invoice","02/05/2020","67","Discount 10% TV Ad","Jean Allen","Discount (Discount)","",,-319.90,-319.90,2879.10
,"Invoice","02/05/2020","67","18' Ground Anchor","Jean Allen","Ground Anchors (18"" Ground Anchor)",7,,30.49,213.43,3092.53
,"Invoice","02/05/2020","67","Z Bracket","Jean Allen","Z Bracket (Z Bracket)",7,,11.23,78.61,3171.14
,"Invoice","02/05/2020","67","Self-opening automatic roof vent","Jean Allen","Automatic Roof Vent (Self-opening automatic roof vent)",1,,65.10,65.10,3236.24
,"Invoice","02/05/2020","67","Univent OT Standard","Jean Allen","Univent OTStandard (Univent OT Standard)",1,,23.90,23.90,3260.14
,"Invoice","02/05/2020","67","10' 110v electric fan w/ shutters","Jean Allen","10"" Shutter Fan (10"" 110v electric fan w/ shutters)",1,,150.05,150.05,3410.19
,"Invoice","02/05/2020","67","Dual Circuit Thermostat","Jean Allen","Thermostatx (Dual Circuit Thermostat)",1,,29.95,29.95,3440.14
,"Invoice","02/05/2020","67","8"" Shelf Bed - 4'","Jean Allen","8"" Shelf Bed -4' (8"" Shelf Bed - 4')",2,,99.95,199.90,3640.04
,"Invoice","02/05/2020","67","4' Shelf","Jean Allen","4' Shelf (4' Shelf)",2,,74.95,149.90,3789.94
,"Invoice","02/05/2020","67","8""  Raised Bed - 4'","Jean Allen","8""  Raised Bed -4' (8""  Raised Bed - 4')",2,,69.95,139.90,3929.84
,"Invoice","02/05/2020","67","Delivery & Install","Jean Allen","Install (Delivery & Install)",1,,635.00,635.00,4564.84
,"Invoice","03/20/2019","16","8' x 20' w/ 4' pop out Cathedral Modular Greenhouse (8' x 24')","Jessica & Zack Stumbaugh","8' x 24' GH Side Cathedral (8' x 24' w/ Side Cathedral Modular Greenhouse)",1,,5495.00,5495.00,5495.00
,"Invoice","03/20/2019","16","Discount Reno Home & Garden Show","Jessica & Zack Stumbaugh","Discount (Discount)","",,-549.50,-600.00,4895.00
,"Invoice","03/20/2019","16","Additional Door - Hinge Left","Jessica & Zack Stumbaugh","Additional Door (Additional Door)",1,,350.00,350.00,5245.00
,"Invoice","03/20/2019","16","Discount","Jessica & Zack Stumbaugh","Discount (Discount)","",,-100.00,-100.00,5145.00
,"Invoice","03/20/2019","16","18' Ground Anchor","Jessica & Zack Stumbaugh","Ground Anchors (18"" Ground Anchor)",15,,27.88,418.20,5563.20
,"Invoice","03/20/2019","16","Z Bracket","Jessica & Zack Stumbaugh","Z Bracket (Z Bracket)",15,,8.70,130.50,5693.70
,"Invoice","03/20/2019","16","Delivery & Install 8 x 24","Jessica & Zack Stumbaugh","Install 8 x 24 (Delivery & Install 8 x 24)",1,,500.00,500.00,6193.70
,"Invoice","03/20/2019","16","Discount Delviery","Jessica & Zack Stumbaugh","Discount (Discount)","",,-500.00,-500.00,5693.70
,"Invoice","03/20/2019","16","Self-opening automatic roof vent","Jessica & Zack Stumbaugh","Automatic Roof Vent (Self-opening automatic roof vent)",4,,65.10,260.40,5954.10
,"Invoice","03/20/2019","16","Univent OT Standard","Jessica & Zack Stumbaugh","Univent OTStandard (Univent OT Standard)",4,,23.90,95.60,6049.70
,"Invoice","03/20/2019","16","Discount Anchor/ Vents","Jessica & Zack Stumbaugh","Discount (Discount)","",,-90.00,-90.00,5959.70
,"Invoice","05/28/2019","30","26' Raised Bed","Jessica & Zack Stumbaugh","26""  Raised Bed (26"" Raised Bed)",7,,97.95,685.65,6645.35
,"Invoice","05/28/2019","30","8' Raised Bed - 6'","Jessica & Zack Stumbaugh","8'  Raised Bed - 6' (8' Raised Bed - 6')",2,,104.93,209.86,6855.21
,"Invoice","05/28/2019","30","8' Shelf Bed - 4'","Jessica & Zack Stumbaugh","8"" Shelf Bed -4' (8"" Shelf Bed - 4')",2,,99.95,199.90,7055.11
,"Invoice","05/28/2019","30","Discount- Reno Home Show","Jessica & Zack Stumbaugh","Discount (Discount)","",,-109.54,-109.54,6945.57
,"Invoice","05/28/2019","30","Delivery & Install","Jessica & Zack Stumbaugh","Accessory Install (Delivery & Install)",1,,75.00,75.00,7020.57
,"Invoice","05/28/2019","30","Discount - Install - return for fixes","Jessica & Zack Stumbaugh","Discount (Discount)","",,-75.00,-75.00,6945.57
,"Invoice","01/03/2020","60","8' x 24' Modular Greenhouse","Jim Hess","8'x24' Modular Greenhouse (8' x 24' Modular Greenhouse)",1,,5995.00,5995.00,5995.00
,"Invoice","01/03/2020","60","Additional Door","Jim Hess","Additional Door (Additional Door)",1,,200.00,200.00,6195.00
,"Invoice","01/03/2020","60","Self-opening automatic roof vent","Jim Hess","Automatic Roof Vent (Self-opening automatic roof vent)",4,,65.10,260.40,6455.40
,"Invoice","01/03/2020","60","Univent OT Standard","Jim Hess","Univent OTStandard (Univent OT Standard)",4,,23.90,95.60,6551.00
,"Invoice","01/03/2020","60","18' Ground Anchor","Jim Hess","Ground Anchors (18"" Ground Anchor)",10,,30.49,304.90,6855.90
,"Invoice","01/03/2020","60","Z Bracket","Jim Hess","Z Bracket (Z Bracket)",10,,11.23,112.30,6968.20
,"Invoice","01/03/2020","60","8"" Shelf Bed - 4'","Jim Hess","8"" Shelf Bed -4' (8"" Shelf Bed - 4')",4,,89.95,359.80,7328.00
,"Invoice","01/03/2020","60","Delivery & Install","Jim Hess","Install (Delivery & Install)",1,,1110.00,1110.00,8438.00
,"Invoice","01/03/2020","60","Discount End of year 10%","Jim Hess","Discount (Discount)","",,-873.91,-873.91,7564.09
,"Invoice","01/03/2020","60","Discount Senior","Jim Hess","Discount (Discount)","",,-313.88,-313.88,7250.21
,"Invoice","01/17/2020","64","8' x 16' w/ Side Cathedral Modular Greenhouse","Joe Leonis","8' x 16' GH Side Cathedral (8' x 16' w/ Side Cathedral Modular Greenhouse)",1,,5249.00,5249.00,5249.00
,"Invoice","01/17/2020","64","Discount -Moana End of   the year   10%","Joe Leonis","Discount (Discount)","",,-524.90,-524.90,4724.10
,"Invoice","01/17/2020","64","Aluminum Powder Coating - Per Frame","Joe Leonis","Custom Powder Coating (Aluminum Powder Coating - Per Frame)",20,"ea",12.00,240.00,4964.10
,"Invoice","01/17/2020","64","18' Ground Anchor","Joe Leonis","Ground Anchors (18"" Ground Anchor)",11,,27.88,306.68,5270.78
,"Invoice","01/17/2020","64","Z Bracket","Joe Leonis","Z Bracket (Z Bracket)",11,,8.70,95.70,5366.48
,"Invoice","01/17/2020","64","26' Raised Bed","Joe Leonis","26""  Raised Bed (26"" Raised Bed)",4,,97.95,391.80,5758.28
,"Invoice","01/17/2020","64","8' Raised Bed - 4'","Joe Leonis","8""  Raised Bed -4' (8""  Raised Bed - 4')",1,,69.95,69.95,5828.23
,"Invoice","01/17/2020","64","8' Shelf Bed - 4'","Joe Leonis","8"" Shelf Bed -4' (8"" Shelf Bed - 4')",1,,99.95,99.95,5928.18
,"Invoice","01/17/2020","64","4' Shelf","Joe Leonis","4' Shelf (4' Shelf)",1,,74.95,74.95,6003.13
,"Invoice","01/17/2020","64","Trim Powder Coating","Joe Leonis","Custom Powder Coating (Aluminum Powder Coating - Per Frame)",1,"ea",250.00,250.00,6253.13
,"Invoice","01/17/2020","64","Self-opening automatic roof vent","Joe Leonis","Automatic Roof Vent (Self-opening automatic roof vent)",4,,65.10,260.40,6513.53
,"Invoice","01/17/2020","64","Univent OT Standard","Joe Leonis","Univent OTStandard (Univent OT Standard)",4,,23.90,95.60,6609.13
,"Invoice","01/17/2020","64"," Swamp Cooler","Joe Leonis","Electric Swamp Cooler Largex ( Swamp Cooler)",1,,550.00,550.00,7159.13
,"Invoice","01/17/2020","64","Delivery & Install","Joe Leonis","Install (Delivery & Install)",1,,1080.00,1080.00,8239.13
,"Invoice","02/04/2019","5","8' x 12' Modular Greenhouse","John Holt","8' x 12' Greenhouse (8' x 12' Modular Greenhouse)",1,,3395.00,3395.00,3395.00
,"Invoice","02/04/2019","5","Discount - Pyramid","John Holt","Discount (Discount)","",,-900.00,-900.00,2495.00
,"Invoice","02/04/2019","5","Self-opening automatic roof vent","John Holt","Automatic Roof Vent (Self-opening automatic roof vent)",2,,65.10,130.20,2625.20
,"Invoice","02/04/2019","5","Univent OT Standard","John Holt","Univent OTStandard (Univent OT Standard)",2,,23.90,47.80,2673.00
,"Invoice","02/04/2019","5",,"John Holt","Concrete  Anchors",1,,50.00,50.00,2723.00
,"Invoice","02/04/2019","5","Delivery & Install 8 x 12","John Holt","Install 8 x 12 (Delivery & Install 8 x 12)",1,,350.00,350.00,3073.00
,"Invoice","05/06/2020","108","8' x 12' Modular Greenhouse","John Ruiter","8' x 12' Greenhouse (8' x 12' Modular Greenhouse)",1,,3749.00,3749.00,3749.00
,"Invoice","05/06/2020","108","Automatic Pop Vent","John Ruiter","Pop Vent (Automatic Pop Vent)",3,"ea",89.00,267.00,4016.00
,"Invoice","05/06/2020","108","26"" Raised Bed","John Ruiter","26""  Raised Bed (26"" Raised Bed)",1,,97.95,97.95,4113.95
,"Invoice","05/06/2020","108","4' Shelf","John Ruiter","4' Shelf (4' Shelf)",4,,74.95,299.80,4413.75
,"Invoice","05/06/2020","108","Solar Fan 16ï¿½","John Ruiter","Solar Fan 16ï¿½ (Solar Fan 16ï¿½)",1,"ea",620.20,620.20,5033.95
,"Invoice","05/06/2020","108","18"" Ground Anchor","John Ruiter","Ground Anchors (18"" Ground Anchor)",9,,30.49,274.41,5308.36
,"Invoice","05/06/2020","108","Z Bracket","John Ruiter","Z Bracket (Z Bracket)",9,,11.23,101.07,5409.43
,"Invoice","05/06/2020","108","Delivery & Install","John Ruiter","Install (Delivery & Install)",1,,649.971,649.97,6059.40
,"Invoice","05/06/2020","108","Discount - Upgarde from 12"" Electric fan to 16"" Solar Fan","John Ruiter","Discount (Discount)","",,-25.00%,-155.05,5904.35
,"Invoice","03/31/2020","82","8' x 20' Modular Greenhouse","Jon Haskins","8'x20' Modular Greenhouse (8' x 20' Modular Greenhouse)",1,,5249.00,5249.00,5249.00
,"Invoice","03/31/2020","82","Automatic Pop Vent","Jon Haskins","Pop Vent (Automatic Pop Vent)",5,"ea",89.00,445.00,5694.00
,"Invoice","03/31/2020","82","26"" Raised Bed","Jon Haskins","26""  Raised Bed (26"" Raised Bed)",5,,97.95,489.75,6183.75
,"Invoice","03/31/2020","82","8"" Shelf Bed - 4'","Jon Haskins","8"" Shelf Bed -4' (8"" Shelf Bed - 4')",5,,99.95,499.75,6683.50
,"Invoice","03/31/2020","82","8""  Raised Bed - 4'","Jon Haskins","8""  Raised Bed -4' (8""  Raised Bed - 4')",5,,69.95,349.75,7033.25
,"Invoice","03/31/2020","82","Electric Swamp Cooler Large","Jon Haskins","Swamp Cooler Large (Electric Swamp Cooler Large)",1,"ea",589.00,589.00,7622.25
,"Invoice","03/31/2020","82","18"" Ground Anchor","Jon Haskins","Ground Anchors (18"" Ground Anchor)",13,,30.49,396.37,8018.62
,"Invoice","03/31/2020","82","Z Bracket","Jon Haskins","Z Bracket (Z Bracket)",13,,11.23,145.99,8164.61
,"Invoice","04/04/2019","25","Custom Lean To","Joyce McIntosh","Custom Greenhouse",1,,2000.00,2000.00,2000.00
,"Invoice","04/04/2019","25","Discount","Joyce McIntosh","Discount (Discount)","",,-300.12,-300.12,1699.88
,"Invoice","04/04/2019","25","Delivery & Install","Joyce McIntosh","Install (Delivery & Install)",1,,500.00,500.00,2199.88
,"Invoice","04/04/2019","25","Discount - free install per Josh","Joyce McIntosh","Discount (Discount)","",,-500.00,-500.00,1699.88
,"Invoice","04/04/2019","25","Solar Fan","Joyce McIntosh","Solar Fan 16""x (Solar Fan)",1,,730.10,730.10,2429.98
,"Invoice","04/04/2019","25","Dual Circuit Thermostat","Joyce McIntosh","Thermostatx (Dual Circuit Thermostat)",1,,29.95,29.95,2459.93
,"Invoice","04/04/2019","25","12' Shutter Vent","Joyce McIntosh","12' Shutter Vent (12' Shutter Vent)",1,,29.95,29.95,2489.88
,"Invoice","05/22/2020","112","8' x 16' Greenhouse w/ 4' Pop-out","Judy Johnson","8'x16' Greenhouse w/ 4' Pop-out (8' x 16' Greenhouse w/ 4' Pop-out)",1,,5995.00,5995.00,5995.00
,"Invoice","05/22/2020","112","18"" Ground Anchor","Judy Johnson","Ground Anchors (18"" Ground Anchor)",13,,30.49,396.37,6391.37
,"Invoice","05/22/2020","112","Z Bracket","Judy Johnson","Z Bracket (Z Bracket)",13,,11.23,145.99,6537.36
,"Invoice","05/22/2020","112","Ground Fencing -under entire GH and Outdoor Beds (price per linear foot of fencing roll)","Judy Johnson","Ground Fencing (Ground Fencing -under entire GH)",30,"yd",6.00,180.00,6717.36
,"Invoice","05/22/2020","112","Automatic Pop Vent","Judy Johnson","Pop Vent (Automatic Pop Vent)",5,"ea",89.00,445.00,7162.36
,"Invoice","05/22/2020","112","Solar Fan 20ï¿½","Judy Johnson","Solar Fan 20ï¿½ (Solar Fan 20ï¿½)",1,"ea",750.10,750.10,7912.46
,"Invoice","05/22/2020","112","26"" Raised Bed (across back side of GH)","Judy Johnson","26""  Raised Bed (26"" Raised Bed)",6,,97.95,587.70,8500.16
,"Invoice","05/22/2020","112","Delivery & Install","Judy Johnson","Install (Delivery & Install)",1,,14.00%,1366.10,9866.26
,"Invoice","05/22/2020","112","4' x 8' x 26"" Raised Bed","Judy Johnson","4' x 8' x 26"" Raised Bed (4' x 8' x 26"" Raised Bed w/Cover)",1,"ea",369.00,369.00,10235.26
,"Invoice","05/22/2020","112","4' x 8' x 8"" Raised Bed","Judy Johnson","4' x 8' x 8"" Raised Bed",1,,289.00,289.00,10524.26
,"Invoice","05/22/2020","112","8"" x 16"" x 4' Shelf Beds (to go above raised beds)","Judy Johnson","8"" Shelf Bed -4' (8"" Shelf Bed - 4')",6,,99.95,599.70,11123.96
,"Invoice","08/17/2020","127","8' x 16' Greenhouse w/ 4' Pop-out","Katie Allen","8'x16' Greenhouse w/ 4' Pop-out (8' x 16' Greenhouse w/ 4' Pop-out)",1,,5995.00,5995.00,5995.00
,"Invoice","08/17/2020","127","Automatic Pop Vent","Katie Allen","Pop Vent (Automatic Pop Vent)",5,"ea",89.00,445.00,6440.00
,"Invoice","08/17/2020","127","18"" Ground Anchor","Katie Allen","Ground Anchors (18"" Ground Anchor)",13,,30.49,396.37,6836.37
,"Invoice","08/17/2020","127","Z Bracket","Katie Allen","Z Bracket (Z Bracket)",13,,11.23,145.99,6982.36
,"Invoice","08/17/2020","127","30,000 BTU Vent Free Blue Flame Natural Gas Heater","Katie Allen","Gas Heater",1,,175.00,175.00,7157.36
,"Invoice","08/17/2020","127","Electric Swamp Cooler Large","Katie Allen","Swamp Cooler Large (Electric Swamp Cooler Large)",1,"ea",600.00,600.00,7757.36
,"Invoice","08/17/2020","127","26"" Raised Bed","Katie Allen","26""  Raised Bed (26"" Raised Bed)",4,,97.95,391.80,8149.16
,"Invoice","08/17/2020","127","13"" Rasied Bed","Katie Allen","13"" Raised Bed",2,,69.95,139.90,8289.06
,"Invoice","08/17/2020","127","8"" Shelf Bed - 4'","Katie Allen","8"" Shelf Bed -4' (8"" Shelf Bed - 4')",2,,99.95,199.90,8488.96
,"Invoice","08/17/2020","127","4' Shelf","Katie Allen","4' Shelf (4' Shelf)",2,,74.95,149.90,8638.86
,"Invoice","08/17/2020","127","5% Referral Discount","Katie Allen","5% Sales Discount (Sales Discount 5%)","",,-5.00%,-431.94,8206.92
,"Invoice","08/17/2020","127","Delivery & Install","Katie Allen","Install (Delivery & Install)",1,,1209.44,1209.44,9416.36
,"Invoice","09/23/2020","135","8' x 12' Modular Greenhouse","Kay Fitzgerald","8' x 12' Greenhouse (8' x 12' Modular Greenhouse)",1,,3749.00,3749.00,3749.00
,"Invoice","09/23/2020","135","Automatic Pop Vent","Kay Fitzgerald","Pop Vent (Automatic Pop Vent)",3,"ea",89.00,267.00,4016.00
,"Invoice","09/23/2020","135","4"" Concrete Tapcons","Kay Fitzgerald","Anchors - Concrete (4"" Concrete Tapcons)",17,"ea",2.00,34.00,4050.00
,"Invoice","09/23/2020","135","13"" Raised Bed","Kay Fitzgerald","13"" Raised Bed",3,,69.95,209.85,4259.85
,"Invoice","09/23/2020","135","4' Shelf","Kay Fitzgerald","4' Shelf (4' Shelf)",2,,74.95,149.90,4409.75
,"Invoice","09/23/2020","135","Solar Fan 16ï¿½","Kay Fitzgerald","Solar Fan 16ï¿½ (Solar Fan 16ï¿½)",1,"ea",620.20,620.20,5029.95
,"Invoice","09/23/2020","135","Mr. Heater 20k BTU Vent-Free NG - per conversation with Jake","Kay Fitzgerald","Gas Heater",1,,215.00,215.00,5244.95
,"Invoice","09/23/2020","135","Veteran Discount","Kay Fitzgerald","10% Veteran Discount","",,-10.00%,-524.50,4720.45
,"Invoice","09/23/2020","135","Delivery & Install","Kay Fitzgerald","Install (Delivery & Install)",1,,734.29,734.29,5454.74
,"Invoice","03/09/2020","78","8' x 20' Modular Greenhouse","Kaydee Faulstich","8'x20' Modular Greenhouse (8' x 20' Modular Greenhouse)",1,,5249.00,5249.00,5249.00
,"Invoice","03/09/2020","78","Automatic Pop Vent","Kaydee Faulstich","Pop Vent (Automatic Pop Vent)",5,"ea",89.00,445.00,5694.00
,"Invoice","03/09/2020","78","4' Shelf","Kaydee Faulstich","4' Shelf (4' Shelf)",2,,74.95,149.90,5843.90
,"Invoice","03/09/2020","78","26"" Raised Bed","Kaydee Faulstich","26""  Raised Bed (26"" Raised Bed)",2,,97.95,195.90,6039.80
,"Invoice","03/09/2020","78","18"" Ground Anchor","Kaydee Faulstich","Ground Anchors (18"" Ground Anchor)",12,,30.49,365.88,6405.68
,"Invoice","03/09/2020","78","Z Bracket","Kaydee Faulstich","Z Bracket (Z Bracket)",12,,11.23,134.76,6540.44
,"Invoice","03/09/2020","78","Delivery & Install","Kaydee Faulstich","Install (Delivery & Install)",1,,873.04,873.04,7413.48
,"Invoice","03/09/2020","78","Per Josh","Kaydee Faulstich","5% Sales Discount (Sales Discount 5%)","",,-355.45,-355.45,7058.03
,"Invoice","03/09/2020","78","16"" 110v Electric Fan w/ Shutters","Kaydee Faulstich","16"" Shutter Fan16A (16"" 110v Electric Fan w/ Shutters)",1,,135.00,135.00,7193.03
,"Invoice","03/09/2020","78","Dual Circuit Thermostat","Kaydee Faulstich","Thermostatx (Dual Circuit Thermostat)",1,,29.95,29.95,7222.98
,"Invoice","03/08/2020","76","8' x 16' w/ Side Cathedral Modular Greenhouse","Kevin E Elsberry","8' x 16' GH Side Cathedral (8' x 16' w/ Side Cathedral Modular Greenhouse)",1,,5249.00,5249.00,5249.00
,"Invoice","03/08/2020","76","Salt Lake City Home-show Discount","Kevin E Elsberry","Discount (Discount)","",,-787.35,-787.35,4461.65
,"Invoice","03/08/2020","76","18"" Ground Anchor","Kevin E Elsberry","Ground Anchors (18"" Ground Anchor)",11,,30.49,335.39,4797.04
,"Invoice","03/08/2020","76","Z Bracket","Kevin E Elsberry","Z Bracket (Z Bracket)",11,,11.23,123.53,4920.57
,"Invoice","03/08/2020","76","Automatic Pop Vent","Kevin E Elsberry","Pop Vent (Automatic Pop Vent)",4,"ea",89.00,356.00,5276.57
,"Invoice","03/08/2020","76","18' Raised Bed","Kevin E Elsberry","18'  Raised Bed (18' Raised Bed)",4,,89.95,359.80,5636.37
,"Invoice","03/08/2020","76","8"" Shelf Bed - 4' (16"" depth)","Kevin E Elsberry","8"" Shelf Bed -4' (8"" Shelf Bed - 4')",4,,99.95,399.80,6036.17
,"Invoice","03/08/2020","76","18' Raised Bed (6' wide)","Kevin E Elsberry","18'  Raised Bed (18' Raised Bed)",2,,89.95,179.90,6216.07
,"Invoice","03/08/2020","76","Electric Swamp Cooler Large","Kevin E Elsberry","Swamp Cooler Large (Electric Swamp Cooler Large)",1,"ea",758.93,758.93,6975.00
,"Invoice","03/08/2020","76","Custom Trim Package (Red)","Kevin E Elsberry","Diamond Plate Trim (Custom Trim)",1,"ea",250.00,250.00,7225.00
,"Invoice","03/08/2020","76","Delivery & Install","Kevin E Elsberry","Install (Delivery & Install)",1,,975.00,975.00,8200.00
,"Invoice","10/24/2019","54","8' x 12' Modular Greenhouse","Kim Martin","8' x 12' Greenhouse (8' x 12' Modular Greenhouse)",1,,3748.90,3748.90,3748.90
,"Invoice","10/24/2019","54","18' Ground Anchor","Kim Martin","Ground Anchors (18"" Ground Anchor)",9,,30.49,274.41,4023.31
,"Invoice","10/24/2019","54","Z Bracket","Kim Martin","Z Bracket (Z Bracket)",9,,11.23,101.07,4124.38
,"Invoice","10/24/2019","54","Self-opening automatic roof vent","Kim Martin","Automatic Roof Vent (Self-opening automatic roof vent)",4,,65.10,260.40,4384.78
,"Invoice","10/24/2019","54","Univent OT Standard","Kim Martin","Univent OTStandard (Univent OT Standard)",4,,23.90,95.60,4480.38
,"Invoice","10/24/2019","54","Delivery & Install","Kim Martin","Install (Delivery & Install)",1,,780.00,780.00,5260.38
,"Invoice","10/24/2019","54","24' Raised Bed","Kim Martin","24'  Raised Bed (24' Raised Bed)",7,,97.95,685.65,5946.03
,"Invoice","05/13/2019","28","8' x 8' Modular Greenhouse","Larry Spearman","8' x 8' Greenhouse (8' x 8' Modular Greenhouse)",1,,3199.00,3199.00,3199.00
,"Invoice","05/13/2019","28","Discount -5% Moana","Larry Spearman","Discount (Discount)","",,-159.95,-159.95,3039.05
,"Invoice","05/13/2019","28","Self-opening automatic roof vent","Larry Spearman","Automatic Roof Vent (Self-opening automatic roof vent)",2,,65.10,130.20,3169.25
,"Invoice","05/13/2019","28","Univent OT Standard","Larry Spearman","Univent OTStandard (Univent OT Standard)",2,,23.90,47.80,3217.05
,"Invoice","05/13/2019","28","18' Ground Anchor","Larry Spearman","Ground Anchors (18"" Ground Anchor)",7,,27.88,195.16,3412.21
,"Invoice","05/13/2019","28","Z Bracket","Larry Spearman","Z Bracket (Z Bracket)",7,,8.70,60.90,3473.11
,"Invoice","05/13/2019","28","Delivery & Install 8 x 8","Larry Spearman","Install 8 x 8 (Delivery & Install 8 x 8)",1,,430.00,430.00,3903.11
,"Invoice","09/09/2019","52","8' x 8' Modular Greenhouse","Laura Mullen","8' x 8' Greenhouse (8' x 8' Modular Greenhouse)",1,,3199.00,3199.00,3199.00
,"Invoice","09/09/2019","52","Discount - Home show","Laura Mullen","Discount (Discount)","",,-160.00,-160.00,3039.00
,"Invoice","09/09/2019","52","Self-opening automatic roof vent","Laura Mullen","Automatic Roof Vent (Self-opening automatic roof vent)",4,,65.10,260.40,3299.40
,"Invoice","09/09/2019","52","Univent OT Standard","Laura Mullen","Univent OTStandard (Univent OT Standard)",4,,23.90,95.60,3395.00
,"Invoice","09/09/2019","52","4' Shelf","Laura Mullen","4' Shelf (4' Shelf)",2,,74.95,149.90,3544.90
,"Invoice","09/09/2019","52","8"" Shelf Bed - 4'","Laura Mullen","8"" Shelf Bed -4' (8"" Shelf Bed - 4')",2,,99.95,199.90,3744.80
,"Invoice","09/09/2019","52","Solar Fan","Laura Mullen","Solar Fan 16""x (Solar Fan)",1,,620.10,620.10,4364.90
,"Invoice","09/09/2019","52","Dual Circuit Thermostat","Laura Mullen","Thermostatx (Dual Circuit Thermostat)",1,,29.95,29.95,4394.85
,"Invoice","09/09/2019","52","18' Ground Anchor","Laura Mullen","Ground Anchors (18"" Ground Anchor)",7,,30.49,213.43,4608.28
,"Invoice","09/09/2019","52","Z Bracket","Laura Mullen","Z Bracket (Z Bracket)",7,,11.23,78.61,4686.89
,"Invoice","09/09/2019","52","Delivery & Install","Laura Mullen","Install (Delivery & Install)",1,,680.00,680.00,5366.89
,"Invoice","03/17/2019","11","8' x 8' Modular Greenhouse","Laura Wikey","8' x 8' Greenhouse (8' x 8' Modular Greenhouse)",1,,2795.00,2795.00,2795.00
,"Invoice","03/17/2019","11","Discount - Reno Home Show","Laura Wikey","Discount (Discount)","",,-280.00,-280.00,2515.00
,"Invoice","03/17/2019","11","18' Ground Anchor","Laura Wikey","Ground Anchors (18"" Ground Anchor)",7,,27.88,195.16,2710.16
,"Invoice","03/17/2019","11","Z Bracket","Laura Wikey","Z Bracket (Z Bracket)",7,,8.70,60.90,2771.06
,"Invoice","03/17/2019","11","Delivery & Install 8 x 8","Laura Wikey","Install 8 x 8 (Delivery & Install 8 x 8)",1,,300.00,300.00,3071.06
,"Invoice","03/17/2019","11","26' Raised Bed(Left Side)","Laura Wikey","26""  Raised Bed (26"" Raised Bed)",2,,97.95,195.90,3266.96
,"Invoice","03/17/2019","11","8' Shelf Bed - 4'(rt front)","Laura Wikey","8"" Shelf Bed -4' (8"" Shelf Bed - 4')",1,,99.95,99.95,3366.91
,"Invoice","03/17/2019","11","4' Shelf (rt back)","Laura Wikey","4' Shelf (4' Shelf)",1,,74.95,74.95,3441.86
,"Invoice","03/17/2019","11","Self-opening automatic roof vent","Laura Wikey","Automatic Roof Vent (Self-opening automatic roof vent)",2,,65.10,130.20,3572.06
,"Invoice","03/17/2019","11","Univent OT Standard","Laura Wikey","Univent OTStandard (Univent OT Standard)",2,,23.90,47.80,3619.86
,"Invoice","04/01/2020","105","8' x 16' Modular Greenhouse","Lauren Griffin","8' x 16' Greenhouse (8' x 16' Modular Greenhouse)",1,,4495.00,4495.00,4495.00
,"Invoice","04/01/2020","105","Automatic Pop Vent","Lauren Griffin","Pop Vent (Automatic Pop Vent)",2,"ea",89.00,178.00,4673.00
,"Invoice","04/01/2020","105","Solar Panel and Inverter Kit for Swamp Cooler - To be paid after installation of Solar Kit","Lauren Griffin","Swamp Cooler Solar Kit (Solar Panel and Inverter Kit for Swamp Cooler)",1,,600.00,600.00,5273.00
,"Invoice","04/01/2020","105","4' Shelf","Lauren Griffin","4' Shelf (4' Shelf)",2,,74.95,149.90,5422.90
,"Invoice","04/01/2020","105","Delivery & Install","Lauren Griffin","Install (Delivery & Install)",1,,832.5758,832.58,6255.48
,"Invoice","04/01/2020","105","Discount- Solar Swamp Cooler Pilot Group Discount","Lauren Griffin","Discount (Discount)","",,-595.00,-595.00,5660.48
,"Invoice","04/01/2020","105","Discount- 10% Discount Fully Loaded Greenhouse per Josh","Lauren Griffin","Discount (Discount)","",,-675.61,-675.61,4984.87
,"Invoice","04/01/2020","105","18"" Ground Anchor","Lauren Griffin","Ground Anchors (18"" Ground Anchor)",9,,30.49,274.41,5259.28
,"Invoice","04/01/2020","105","Z Bracket","Lauren Griffin","Z Bracket (Z Bracket)",9,,11.23,101.07,5360.35
,"Invoice","05/19/2020","110","8' x 16' w/ Side Cathedral Modular Greenhouse","Laurie Lile","8' x 16' GH Side Cathedral (8' x 16' w/ Side Cathedral Modular Greenhouse)",1,,5249.00,5249.00,5249.00
,"Invoice","05/19/2020","110","Wind/Snow Package","Laurie Lile","Wind/Snow Package (Wind/Snow Package)",4,,"",0.00,5249.00
,"Invoice","05/19/2020","110","26"" Raised Bed","Laurie Lile","26""  Raised Bed (26"" Raised Bed)",4,,97.95,391.80,5640.80
,"Invoice","05/19/2020","110","4' Shelf","Laurie Lile","4' Shelf (4' Shelf)",2,,74.95,149.90,5790.70
,"Invoice","05/19/2020","110","Automatic Pop Vent","Laurie Lile","Pop Vent (Automatic Pop Vent)",4,"ea",89.00,356.00,6146.70
,"Invoice","05/19/2020","110","Electric Swamp Cooler Large","Laurie Lile","Swamp Cooler Large (Electric Swamp Cooler Large)",1,"ea",600.00,600.00,6746.70
,"Invoice","05/19/2020","110","18"" Ground Anchor","Laurie Lile","Ground Anchors (18"" Ground Anchor)",9,,30.49,274.41,7021.11
,"Invoice","05/19/2020","110","Z Bracket","Laurie Lile","Z Bracket (Z Bracket)",9,,11.23,101.07,7122.18
,"Invoice","05/19/2020","110","Delivery & Install","Laurie Lile","Install (Delivery & Install)",1,,891.5452,891.55,8013.73
,"Invoice","05/19/2020","110","Discount- 5% Fully Loaded Greenhouse Discount","Laurie Lile","Discount (Discount)","",,-362.9865,-362.99,7650.74
,"Invoice","03/04/2019","9","4' x 2' x 26"" Raised Bed w/ 16"" Cover","Linda Campbell","4' x 2' x 26"" Raised Bed (4' x 2' x 26"" Raised Bed w/ 16"" Cover)",1,"ea",465.00,465.00,465.00
,"Invoice","03/04/2019","9","Discount","Linda Campbell","Discount (Discount)","",,-70.00,-70.00,395.00
,"Invoice","08/28/2020","130","8' x 24' Greenhouse w/ 4' Pop-out","Lisa Glavish","8'x24' Greenhouse w/ 4' Pop-out (8' x 24' Greenhouse w/ 4' Pop-out)",1,,7499.00,7499.00,7499.00
,"Invoice","08/28/2020","130","Wind/Snow Package","Lisa Glavish","Wind/Snow Package (Wind/Snow Package)",6,,94.95,569.70,8068.70
,"Invoice","08/28/2020","130","18"" Ground Anchor","Lisa Glavish","Ground Anchors (18"" Ground Anchor)",17,,30.49,518.33,8587.03
,"Invoice","08/28/2020","130","Z Bracket","Lisa Glavish","Z Bracket (Z Bracket)",17,,11.23,190.91,8777.94
,"Invoice","08/28/2020","130","Automatic Pop Vent","Lisa Glavish","Pop Vent (Automatic Pop Vent)",7,"ea",89.00,623.00,9400.94
,"Invoice","08/28/2020","130","26"" Raised Bed","Lisa Glavish","26""  Raised Bed (26"" Raised Bed)",8,,97.95,783.60,10184.54
,"Invoice","08/28/2020","130","13"" Raised Bed","Lisa Glavish","13"" Raised Bed",3,,69.95,209.85,10394.39
,"Invoice","08/28/2020","130","8"" Shelf Bed - 4'","Lisa Glavish","8"" Shelf Bed -4' (8"" Shelf Bed - 4')",3,,99.95,299.85,10694.24
,"Invoice","08/28/2020","130","4' Shelf","Lisa Glavish","4' Shelf (4' Shelf)",1,,74.95,74.95,10769.19
,"Invoice","08/28/2020","130","Electric Swamp Cooler Large","Lisa Glavish","Swamp Cooler Large (Electric Swamp Cooler Large)",1,"ea",600.00,600.00,11369.19
,"Invoice","08/28/2020","130","Sales Discount 5% - Fully Loaded","Lisa Glavish","5% Sales Discount (Sales Discount 5%)","",,-5.00%,-587.71,10781.48
,"Invoice","08/28/2020","130","Delivery & Install","Lisa Glavish","Install (Delivery & Install)",1,,1598.54,1598.54,12380.02
,"Invoice","08/28/2020","130","Additional Door","Lisa Glavish","Additional Door (Additional Door)",1,,350.00,350.00,12730.02
,"Invoice","08/28/2020","130","Digital Thermostat","Lisa Glavish","Thermostat (Dual Circuit Thermostat)",1,"ea",34.95,34.95,12764.97
,"Invoice","06/11/2019","33","8' x 16' Greenhouse w/ 4' Pop-out","Lisa Hoxie","8'x16' Greenhouse w/ 4' Pop-out (8' x 16' Greenhouse w/ 4' Pop-out)",1,,5995.00,5995.00,5995.00
,"Invoice","06/11/2019","33","Discount","Lisa Hoxie","Discount (Discount)","",,-999.49,-999.49,4995.51
,"Invoice","06/11/2019","33","Additional Door (Side Door Hinge Right )","Lisa Hoxie","Additional Door (Additional Door)",1,,350.00,350.00,5345.51
,"Invoice","06/11/2019","33","Half Door - top only open","Lisa Hoxie","Additional Door (Additional Door)",1,,175.00,175.00,5520.51
,"Invoice","06/11/2019","33","26' Raised Bed","Lisa Hoxie","26""  Raised Bed (26"" Raised Bed)",4,,97.95,391.80,5912.31
,"Invoice","06/11/2019","33","8' Raised Bed - 4'","Lisa Hoxie","8""  Raised Bed -4' (8""  Raised Bed - 4')",2,,69.95,139.90,6052.21
,"Invoice","06/11/2019","33","8' Shelf Bed - 4'","Lisa Hoxie","8"" Shelf Bed -4' (8"" Shelf Bed - 4')",2,,99.95,199.90,6252.11
,"Invoice","06/11/2019","33","4' Shelf","Lisa Hoxie","4' Shelf (4' Shelf)",1,,74.95,74.95,6327.06
,"Invoice","06/11/2019","33","4' Shelf - Solid Work Bench","Lisa Hoxie","4'  Shelf  - Solid (4' Shelf - Solid Work Bench)",1,,74.95,74.95,6402.01
,"Invoice","06/11/2019","33","Self-opening automatic roof vent","Lisa Hoxie","Automatic Roof Vent (Self-opening automatic roof vent)",5,,65.10,325.50,6727.51
,"Invoice","06/11/2019","33","Univent OT Standard","Lisa Hoxie","Univent OTStandard (Univent OT Standard)",5,,23.90,119.50,6847.01
,"Invoice","06/11/2019","33","18' Ground Anchor","Lisa Hoxie","Ground Anchors (18"" Ground Anchor)",13,,30.49,396.37,7243.38
,"Invoice","06/11/2019","33","Z Bracket","Lisa Hoxie","Z Bracket (Z Bracket)",13,,11.23,145.99,7389.37
,"Invoice","06/11/2019","33","Delivery & Install","Lisa Hoxie","Install (Delivery & Install)",1,,900.00,900.00,8289.37
,"Invoice","02/26/2019","8","8' x 8' Modular Greenhouse","Lisa Welch","8' x 8' Greenhouse (8' x 8' Modular Greenhouse)",1,,2795.00,2795.00,2795.00
,"Invoice","02/26/2019","8","18' Ground Anchor","Lisa Welch","Ground Anchors (18"" Ground Anchor)",7,,27.88,195.16,2990.16
,"Invoice","02/26/2019","8","Z Bracket","Lisa Welch","Z Bracket (Z Bracket)",7,,8.70,60.90,3051.06
,"Invoice","02/26/2019","8","12' 110v Electric Fan w/ Shutters","Lisa Welch","12"" Shutter Fan12A (12"" 110v Electric Fan w/ Shutters)",1,,169.00,169.00,3220.06
,"Invoice","02/26/2019","8","Dual Circuit Thermostat","Lisa Welch","Thermostatx (Dual Circuit Thermostat)",1,,29.95,29.95,3250.01
,"Invoice","02/26/2019","8","12' Shutter Vent","Lisa Welch","12' Shutter Vent (12' Shutter Vent)",1,,29.95,29.95,3279.96
,"Invoice","02/26/2019","8","26' Raised Bed (down 1 Side of GH)","Lisa Welch","26""  Raised Bed (26"" Raised Bed)",2,,97.95,195.90,3475.86
,"Invoice","02/26/2019","8","8' Raised Bed - 4' (down 1 side of GH)","Lisa Welch","8""  Raised Bed -4' (8""  Raised Bed - 4')",2,,69.95,139.90,3615.76
,"Invoice","02/26/2019","8","4' Shelf ( above 8"" raised beds)","Lisa Welch","4' Shelf (4' Shelf)",2,,74.95,149.90,3765.66
,"Invoice","02/26/2019","8","Delivery & Install 8 x 8","Lisa Welch","Install 8 x 8 (Delivery & Install 8 x 8)",1,,350.00,350.00,4115.66
,"Invoice","02/26/2019","8","Discount 10% GH - winter sale (saw at montesorri School)","Lisa Welch","Discount (Discount)","",,-279.00,-279.00,3836.66
,"Invoice","07/24/2019","42","8' x 16' Modular Greenhouse","Louis Ferraro","8' x 16' Greenhouse (8' x 16' Modular Greenhouse)",1,,4495.00,4495.00,4495.00
,"Invoice","07/24/2019","42","Discount - Carson home show","Louis Ferraro","Discount (Discount)","",,"",-468.20,4026.80
,"Invoice","07/24/2019","42",,"Louis Ferraro","Concrete  Anchors",1,,64.00,64.00,4090.80
,"Invoice","07/24/2019","42","Self-opening automatic roof vent","Louis Ferraro","Automatic Roof Vent (Self-opening automatic roof vent)",4,,65.10,260.40,4351.20
,"Invoice","07/24/2019","42","Univent OT Standard","Louis Ferraro","Univent OTStandard (Univent OT Standard)",4,,23.90,95.60,4446.80
,"Invoice","07/24/2019","42","26' Raised Bed","Louis Ferraro","26""  Raised Bed (26"" Raised Bed)",5,,97.95,489.75,4936.55
,"Invoice","07/24/2019","42","8' Shelf Bed - 4'","Louis Ferraro","8"" Shelf Bed -4' (8"" Shelf Bed - 4')",3,,99.95,299.85,5236.40
,"Invoice","07/24/2019","42","16' 110v Electric Fan w/ Shutters","Louis Ferraro","16"" Shutter Fan16A (16"" 110v Electric Fan w/ Shutters)",1,,135.00,135.00,5371.40
,"Invoice","07/24/2019","42","Dual Circuit Thermostat","Louis Ferraro","Thermostatx (Dual Circuit Thermostat)",1,,29.95,29.95,5401.35
,"Invoice","07/24/2019","42","12' Shutter Vent","Louis Ferraro","12' Shutter Vent (12' Shutter Vent)",1,,29.95,29.95,5431.30
,"Invoice","07/24/2019","42","Delivery & Install","Louis Ferraro","Install (Delivery & Install)",1,,738.00,738.00,6169.30
,"Invoice","03/31/2020","79","U Shape Greenhouse","Makita","16 x 24 Greenhouse",1,"ea",9800.00,9800.00,9800.00
,"Invoice","03/31/2020","79","5% Discount (per Josh)","Makita","Discount (Discount)","",,-490.00,-490.00,9310.00
,"Invoice","03/31/2020","79","Aluminum Powder Coating - Per Frame","Makita","Custom Powder Coating (Aluminum Powder Coating - Per Frame)",45,"ea",22.00,990.00,10300.00
,"Invoice","03/31/2020","79","Automatic Pop Vent","Makita","Pop Vent (Automatic Pop Vent)",10,"ea",89.00,890.00,11190.00
,"Invoice","03/31/2020","79","26"" Ground Anchors","Makita","Ground Anchors - 26"" (26"" Ground Anchors)",20,,47.00,940.00,12130.00
,"Invoice","03/31/2020","79","Z Bracket","Makita","Z Bracket (Z Bracket)",20,,11.23,224.60,12354.60
,"Invoice","03/31/2020","79"," Swamp Cooler","Makita","Electric Swamp Cooler Largex ( Swamp Cooler)",1,,600.00,600.00,12954.60
,"Invoice","03/31/2020","79","Budget for Custom Beds for inide the greenhouse (TBD by Customer)","Makita","Custom Beds (Budget for Custom Beds)",1,"ea",1800.00,1800.00,14754.60
,"Invoice","03/31/2020","79","Clear glass like panels for sidewalls","Makita","Clear Sheet Upgrade (Clear glass like panels for sidewalls)",22,"ea",19.84,436.48,15191.08
,"Invoice","03/31/2020","79","Ground fencing under greenhouse","Makita","Ground Fencing (Ground Fencing -under entire GH)",18,"yd",6.00,108.00,15299.08
,"Invoice","03/31/2020","79","Delivery & Install","Makita","Install (Delivery & Install)",1,,1960.00,1960.00,17259.08
,"Invoice","03/31/2020","79","Run load calcs on soil (normally $5500 for new/custom build)","Makita","Engineering",1,"ea",1300.00,1300.00,18559.08
,"Invoice","03/31/2020","79","Custom Trim","Makita","Diamond Plate Trim (Custom Trim)",1,"ea",950.00,950.00,19509.08
,"Invoice","03/31/2020","79","Diamond Plate Trim  & Makita Sign - Comp (per Josh)","Makita","Comp (JS)",1,,-950.00,-950.00,18559.08
,"Invoice","03/31/2020","79","Makita Tools: 3 - XDT16T, 1 - XWT07T, 1 - XRH07PTU  (Quote from Apex Saw)","Makita","Makita Tools (Makita Tools)",1,,2208.55,2208.55,20767.63
,"Invoice","03/31/2020","79","** CUSTOM RAISED BEDS ** 3' x 12' x 20"" Tall raised bed boxes with upgraded planter caps; TBD by...","Makita","4' x 12' x 26""'  Raised Bed (4' x 12' x 26""  Raised Bed)",4,"ea",687.00,2748.00,23515.63
,"Invoice","03/31/2020","79","Sales Discount 10%","Makita","10% Sales Discount (Sales Discount 10%)","",,-10.00%,-274.80,23240.83
,"Invoice","06/15/2020","113","** CUSTOM RAISED BEDS **  3' x 12' x 20"" Tall Raised bed boxes with upgraded planter caps, TBD b...","Makita","4' x 12' x 26""'  Raised Bed (4' x 12' x 26""  Raised Bed)",4,"ea",687.00,2748.00,25988.83
,"Invoice","06/15/2020","113","10% Discount","Makita","Discount (Discount)","",,-274.80,-274.80,25714.03
,"Invoice","04/08/2020","87","8' x 8' Modular Greenhouse","Marcus Boundy","8' x 8' Greenhouse (8' x 8' Modular Greenhouse)",1,,3199.00,3199.00,3199.00
,"Invoice","04/08/2020","87","8""  Raised Bed - 4'","Marcus Boundy","8""  Raised Bed -4' (8""  Raised Bed - 4')",2,,69.95,139.90,3338.90
,"Invoice","04/08/2020","87","8' Shelf Bed - 6'","Marcus Boundy","8""  Shelf Bed - 6' (8' Shelf Bed - 6')",2,,149.93,299.86,3638.76
,"Invoice","04/08/2020","87","26"" Raised Bed","Marcus Boundy","26""  Raised Bed (26"" Raised Bed)",1,,97.95,97.95,3736.71
,"Invoice","04/08/2020","87","Discount- per Josh","Marcus Boundy","Discount (Discount)","",,-408.80,-408.80,3327.91
,"Invoice","01/14/2019","1","8' x 12' Modular Greenhouse","Mark Boge","8' x 12' Greenhouse (8' x 12' Modular Greenhouse)",1,,3195.00,3195.00,3195.00
,"Invoice","01/14/2019","1","Discount Winter Special 15%","Mark Boge","Discount (Discount)","",,-479.20,-479.20,2715.80
,"Invoice","01/14/2019","1","18' Ground Anchor","Mark Boge","Ground Anchors (18"" Ground Anchor)",9,,27.88,250.92,2966.72
,"Invoice","01/14/2019","1","Z Bracket","Mark Boge","Z Bracket (Z Bracket)",9,,8.70,78.30,3045.02
,"Invoice","01/14/2019","1","Delivery & Install 8 x 12","Mark Boge","Install 8 x 12 (Delivery & Install 8 x 12)",1,,350.00,350.00,3395.02
,"Invoice","01/14/2019","1","8' Shelf Bed - 4'","Mark Boge","8"" Shelf Bed -4' (8"" Shelf Bed - 4')",2,,99.95,199.90,3594.92
,"Invoice","01/14/2019","1","24' Raised Bed","Mark Boge","24'  Raised Bed (24' Raised Bed)",2,,89.95,179.90,3774.82
,"Invoice","01/14/2019","1","Self-opening automatic roof vent","Mark Boge","Automatic Roof Vent (Self-opening automatic roof vent)",6,,65.10,390.60,4165.42
,"Invoice","01/14/2019","1","Univent OT Standard","Mark Boge","Univent OTStandard (Univent OT Standard)",6,,23.90,143.40,4308.82
,"Invoice","01/14/2019","1","Deposit to MG $2507.45 12-21-18","Mark Boge","Discount (Discount)","",,-2507.45,-2507.45,1801.37
,"Invoice","05/06/2019","29"," Swamp Cooler","Mark Boge","Electric Swamp Cooler Largex ( Swamp Cooler)",1,,349.98,349.98,2151.35
,"Invoice","09/25/2020","136","8' x 8' Modular Greenhouse","Mark Carter","8' x 8' Greenhouse (8' x 8' Modular Greenhouse)",1,,3199.00,3199.00,3199.00
,"Invoice","09/25/2020","136","Automatic Pop Vent","Mark Carter","Pop Vent (Automatic Pop Vent)",1,"ea",89.00,89.00,3288.00
,"Invoice","09/25/2020","136","Wind/Snow Package","Mark Carter","Wind/Snow Package (Wind/Snow Package)",2,,74.95,149.90,3437.90
,"Invoice","09/25/2020","136","18"" Ground Anchor","Mark Carter","Ground Anchors (18"" Ground Anchor)",5,,30.49,152.45,3590.35
,"Invoice","09/25/2020","136","Z Bracket","Mark Carter","Z Bracket (Z Bracket)",5,,11.23,56.15,3646.50
,"Invoice","09/25/2020","136","4' Shelf","Mark Carter","4' Shelf (4' Shelf)",2,,74.95,149.90,3796.40
,"Invoice","09/25/2020","136","13"" Raised Bed","Mark Carter","13"" Raised Bed",2,,69.95,139.90,3936.30
,"Invoice","09/25/2020","136","Electric Swamp Cooler Large","Mark Carter","Swamp Cooler Large (Electric Swamp Cooler Large)",1,"ea",600.00,600.00,4536.30
,"Invoice","09/25/2020","136","Sales Discount 5% - Moana","Mark Carter","5% Sales Discount (Sales Discount 5%)","",,-5.00%,-226.82,4309.48
,"Invoice","09/25/2020","136","Delivery & Install","Mark Carter","Install (Delivery & Install)",1,,727.75,727.75,5037.23
,"Invoice","08/30/2019","51","8' x 20' Greenhouse w/ 4' Pop-out","Mark Clendenen","8'x20' Greenhouse w/ 4' Pop-out (8' x 20' Greenhouse w/ 4' Pop-out)",1,,6749.00,6749.00,6749.00
,"Invoice","08/30/2019","51","Discount","Mark Clendenen","Discount (Discount)","",,-337.45,-337.45,6411.55
,"Invoice","08/30/2019","51","18' Raised Bed","Mark Clendenen","18'  Raised Bed (18' Raised Bed)",5,,89.95,449.75,6861.30
,"Invoice","08/30/2019","51","26' Raised Bed","Mark Clendenen","26""  Raised Bed (26"" Raised Bed)",1,,97.95,97.95,6959.25
,"Invoice","08/30/2019","51","8' Raised Bed - 4'","Mark Clendenen","8""  Raised Bed -4' (8""  Raised Bed - 4')",4,,69.95,279.80,7239.05
,"Invoice","08/30/2019","51","8' Shelf Bed - 4'","Mark Clendenen","8"" Shelf Bed -4' (8"" Shelf Bed - 4')",4,,99.95,399.80,7638.85
,"Invoice","08/30/2019","51","4' Shelf","Mark Clendenen","4' Shelf (4' Shelf)",1,,74.95,74.95,7713.80
,"Invoice","08/30/2019","51","Self-opening automatic roof vent","Mark Clendenen","Automatic Roof Vent (Self-opening automatic roof vent)",3,,65.10,195.30,7909.10
,"Invoice","08/30/2019","51","Univent OT Standard","Mark Clendenen","Univent OTStandard (Univent OT Standard)",3,,23.90,71.70,7980.80
,"Invoice","08/30/2019","51","18' Ground Anchor","Mark Clendenen","Ground Anchors (18"" Ground Anchor)",15,,30.49,457.35,8438.15
,"Invoice","08/30/2019","51","Z Bracket","Mark Clendenen","Z Bracket (Z Bracket)",15,,11.23,168.45,8606.60
,"Invoice","08/30/2019","51"," Swamp Cooler","Mark Clendenen","Electric Swamp Cooler Largex ( Swamp Cooler)",1,,422.16,422.16,9028.76
,"Invoice","05/21/2020","106","8' x 20' Greenhouse w/ 4' Pop-out","Marsha Davy","8'x20' Greenhouse w/ 4' Pop-out (8' x 20' Greenhouse w/ 4' Pop-out)",1,,6749.00,6749.00,6749.00
,"Invoice","05/21/2020","106","Automatic Pop Vent","Marsha Davy","Pop Vent (Automatic Pop Vent)",5,"ea",89.00,445.00,7194.00
,"Invoice","05/21/2020","106","4' x 2' Work Bench","Marsha Davy","4' Work Bench (4' x 2' Work Bench)",1,"ea",55.00,55.00,7249.00
,"Invoice","05/21/2020","106","26"" Raised Bed","Marsha Davy","26""  Raised Bed (26"" Raised Bed)",3,,97.95,293.85,7542.85
,"Invoice","05/21/2020","106","Electric Swamp Cooler Large","Marsha Davy","Swamp Cooler Large (Electric Swamp Cooler Large)",1,"ea",600.00,600.00,8142.85
,"Invoice","05/21/2020","106","Delivery & Install","Marsha Davy","Install (Delivery & Install)",1,,1213.443,1213.44,9356.29
,"Invoice","05/21/2020","106","4' Shelf","Marsha Davy","4' Shelf (4' Shelf)",3,,74.95,224.85,9581.14
,"Invoice","05/21/2020","106","26"" Ground Anchors","Marsha Davy","Ground Anchors - 26"" (26"" Ground Anchors)",15,,47.00,705.00,10286.14
,"Invoice","05/21/2020","106","Z Bracket","Marsha Davy","Z Bracket (Z Bracket)",15,,11.23,168.45,10454.59
,"Invoice","04/24/2020","93","Automatic Pop Vent","Marsha Matzkanin","Pop Vent (Automatic Pop Vent)",2,"ea",89.00,178.00,178.00
,"Invoice","05/06/2020","100","8' x 16' w/ Side Cathedral Modular Greenhouse","Megan Lahti","8' x 16' GH Side Cathedral (8' x 16' w/ Side Cathedral Modular Greenhouse)",1,,5249.00,5249.00,5249.00
,"Invoice","05/06/2020","100","Automatic Pop Vent","Megan Lahti","Pop Vent (Automatic Pop Vent)",4,"ea",89.00,356.00,5605.00
,"Invoice","05/06/2020","100","18"" Ground Anchor","Megan Lahti","Ground Anchors (18"" Ground Anchor)",1,,30.49,30.49,5635.49
,"Invoice","05/06/2020","100","Z Bracket","Megan Lahti","Z Bracket (Z Bracket)",1,,11.23,11.23,5646.72
,"Invoice","05/06/2020","100","Discount- Discount per Josh for Educational Institution","Megan Lahti","Discount (Discount)","",,-1129.344,-1129.34,4517.38
,"Invoice","05/06/2020","100","4' Shelf","Megan Lahti","4' Shelf (4' Shelf)",5,,74.95,374.75,4892.13
,"Invoice","05/06/2020","100","Date Change Incentive","Megan Lahti","Discount (Discount)","",,-100.00%,-374.75,4517.38
,"Invoice","09/11/2020","131","8' x 20' Modular Greenhouse","Michael Dickinson","8'x20' Modular Greenhouse (8' x 20' Modular Greenhouse)",1,,5249.00,5249.00,5249.00
,"Invoice","09/11/2020","131","Automatic Pop Vent","Michael Dickinson","Pop Vent (Automatic Pop Vent)",4,"ea",89.00,356.00,5605.00
,"Invoice","09/11/2020","131","Ground Fencing - under beds only","Michael Dickinson","Ground Fencing (Ground Fencing -under entire GH)",22,"yd",6.00,132.00,5737.00
,"Invoice","09/11/2020","131","18"" Ground Anchor","Michael Dickinson","Ground Anchors (18"" Ground Anchor)",13,,30.49,396.37,6133.37
,"Invoice","09/11/2020","131","Z Bracket","Michael Dickinson","Z Bracket (Z Bracket)",13,,11.23,145.99,6279.36
,"Invoice","09/11/2020","131","Solar Fan 16ï¿½","Michael Dickinson","Solar Fan 16ï¿½ (Solar Fan 16ï¿½)",1,"ea",620.20,620.20,6899.56
,"Invoice","09/11/2020","131","26"" Raised Bed","Michael Dickinson","26""  Raised Bed (26"" Raised Bed)",5,,97.95,489.75,7389.31
,"Invoice","09/11/2020","131","13"" Raised Bed","Michael Dickinson","13"" Raised Bed",3,,69.95,209.85,7599.16
,"Invoice","09/11/2020","131","8"" Shelf Bed","Michael Dickinson","8"" Shelf Bed -4' (8"" Shelf Bed - 4')",2,,99.95,199.90,7799.06
,"Invoice","09/11/2020","131","4' Shelf","Michael Dickinson","4' Shelf (4' Shelf)",1,,74.95,74.95,7874.01
,"Invoice","09/11/2020","131","Delivery & Install","Michael Dickinson","Install (Delivery & Install)","",,14.00%,1102.36,8976.37
,"Invoice","09/11/2020","131","Sales Discount 5% - Cash Payment","Michael Dickinson","5% Sales Discount (Sales Discount 5%)","",,-5.00%,-448.82,8527.55
,"Invoice","09/11/2020","131","Sales Discount 5% - Moana","Michael Dickinson","5% Sales Discount (Sales Discount 5%)","",,-5.00%,-448.82,8078.73
,"Invoice","09/11/2020","131","Sales Discount 10% - per Brittany","Michael Dickinson","10% Sales Discount (Sales Discount 10%)","",,-10.00%,-897.64,7181.09
,"Invoice","06/12/2020","119","8' x 24' Modular Greenhouse","Michael Weber","8'x24' Modular Greenhouse (8' x 24' Modular Greenhouse)",1,,5995.00,5995.00,5995.00
,"Invoice","06/12/2020","119","26"" Raised Bed","Michael Weber","26""  Raised Bed (26"" Raised Bed)",6,,97.95,587.70,6582.70
,"Invoice","06/12/2020","119","8"" Shelf Bed - 4'","Michael Weber","8"" Shelf Bed -4' (8"" Shelf Bed - 4')",6,,99.95,599.70,7182.40
,"Invoice","06/12/2020","119","8""  Raised Bed - 4'","Michael Weber","8""  Raised Bed -4' (8""  Raised Bed - 4')",6,,69.95,419.70,7602.10
,"Invoice","06/12/2020","119","Automatic Pop Vent","Michael Weber","Pop Vent (Automatic Pop Vent)",6,"ea",89.00,534.00,8136.10
,"Invoice","06/12/2020","119","Electric Swamp Cooler Large","Michael Weber","Swamp Cooler Large (Electric Swamp Cooler Large)",1,"ea",600.00,600.00,8736.10
,"Invoice","06/12/2020","119","18"" Ground Anchor","Michael Weber","Ground Anchors (18"" Ground Anchor)",15,,30.49,457.35,9193.45
,"Invoice","06/12/2020","119","Z Bracket","Michael Weber","Z Bracket (Z Bracket)",15,,11.23,168.45,9361.90
,"Invoice","06/12/2020","119","Delivery & Install","Michael Weber","Install (Delivery & Install)",1,,1669.36,1669.36,11031.26
,"Invoice","06/12/2020","119","Full Kit Discount (per Josh)","Michael Weber","Discount (Discount)","",,-10.00%,-1120.63,9910.63
,"Invoice","06/12/2020","119","30,000 BTU Vent Free Blue Flame Natural Gas Heater","Michael Weber","Gas Heater",1,,175.00,175.00,10085.63
,"Invoice","03/18/2019","12","Falcon Model 4' x 4' x 26"" Raised w/ Auto Pop up vent","Mindy Barrett","Falcon Model (Falcon Model 4' x 4' x 26"" Raised bed & Cover w/ Auto Pop up vent)",1,"ea",999.00,999.00,999.00
,"Invoice","03/18/2019","12","Discount Home & Garden Show","Mindy Barrett","Discount (Discount)","",,-307.18,-307.18,691.82
,"Invoice","03/18/2019","12","Raised Bed Delivery","Mindy Barrett","Raised Bed Delivery (Raised Bed Delivery)",1,,75.00,75.00,766.82
,"Invoice","03/18/2019","12","Discount  Delivery","Mindy Barrett","Discount (Discount)","",,-75.00,-75.00,691.82
,"Invoice","01/08/2020","62","8' x 4' Addition to current 8 x 8 GH","Nan Stoval","8' x 4'   Addition (8' x 4' Addition to current GH)",1,,750.00,750.00,750.00
,"Invoice","01/08/2020","62","18' Ground Anchor","Nan Stoval","Ground Anchors (18"" Ground Anchor)",2,,30.49,60.98,810.98
,"Invoice","01/08/2020","62","Z Bracket","Nan Stoval","Z Bracket (Z Bracket)",2,,11.23,22.46,833.44
,"Invoice","01/08/2020","62","Self-opening automatic roof vent","Nan Stoval","Automatic Roof Vent (Self-opening automatic roof vent)",2,,65.10,130.20,963.64
,"Invoice","01/08/2020","62","Univent OT Standard","Nan Stoval","Univent OTStandard (Univent OT Standard)",2,,23.90,47.80,1011.44
,"Invoice","01/08/2020","62","8"" Shelf Bed - 4'","Nan Stoval","8"" Shelf Bed -4' (8"" Shelf Bed - 4')",1,,99.95,99.95,1111.39
,"Invoice","01/08/2020","62","Discount","Nan Stoval","Discount (Discount)","",,-111.14,-111.14,1000.25
,"Invoice","01/08/2020","62","Delivery & Install","Nan Stoval","Install (Delivery & Install)",1,,250.00,250.00,1250.25
,"Invoice","01/08/2020","62","Additional $100 for every 25 miles outside Reno/Sparks","Nan Stoval","Additional Delivery Fee (Additional $100 for every 25 miles outside Reno/Sparks)",1,,100.00,100.00,1350.25
,"Invoice","01/08/2020","62","4' Shelf","Nan Stoval","4' Shelf (4' Shelf)",1,,74.95,74.95,1425.20
,"Invoice","04/06/2020","85","8' x 12' Modular Greenhouse","Nancy  Johnson","8' x 12' Greenhouse (8' x 12' Modular Greenhouse)",1,,3749.00,3749.00,3749.00
,"Invoice","04/06/2020","85","Discount","Nancy  Johnson","Discount (Discount)","",,-187.45,-187.45,3561.55
,"Invoice","04/06/2020","85","18' Raised Bed","Nancy  Johnson","18'  Raised Bed (18' Raised Bed)",3,,89.95,269.85,3831.40
,"Invoice","04/06/2020","85","4' Shelf","Nancy  Johnson","4' Shelf (4' Shelf)",2,,74.95,149.90,3981.30
,"Invoice","04/06/2020","85","Self-opening automatic roof vent","Nancy  Johnson","Automatic Roof Vent (Self-opening automatic roof vent)",4,,65.10,260.40,4241.70
,"Invoice","04/06/2020","85","Univent OT Standard","Nancy  Johnson","Univent OTStandard (Univent OT Standard)",4,,23.90,95.60,4337.30
,"Invoice","04/06/2020","85","18' Ground Anchor","Nancy  Johnson","Ground Anchors (18"" Ground Anchor)",9,,30.49,274.41,4611.71
,"Invoice","04/06/2020","85","Z Bracket","Nancy  Johnson","Z Bracket (Z Bracket)",9,,11.23,101.07,4712.78
,"Invoice","04/06/2020","85","Delivery & Install","Nancy  Johnson","Install (Delivery & Install)",1,,690.00,690.00,5402.78
,"Invoice","08/13/2019","45","Break down 2 8 x16 GH","Nina Hees","Install (Delivery & Install)",1,,1085.00,1085.00,1085.00
,"Invoice","08/13/2019","45"," Swamp Cooler","Nina Hees","Electric Swamp Cooler Largex ( Swamp Cooler)",1,,420.90,420.90,1505.90
,"Invoice","08/13/2019","45","Discount - anchor return 10 anchors @ 35$","Nina Hees","Discount (Discount)","",,-350.00,-350.00,1155.90
,"Invoice","08/03/2020","129","Electric Swamp Cooler Large","Nina Hees","Swamp Cooler Large (Electric Swamp Cooler Large)",1,"ea",600.00,600.00,1755.90
,"Invoice","08/03/2020","129","Delivery & Install","Nina Hees","Install (Delivery & Install)",1,,84.00,84.00,1839.90
,"Invoice","09/24/2020","134","8' x 8' Modular Greenhouse","Patty Clark","8' x 8' Greenhouse (8' x 8' Modular Greenhouse)",1,,3199.00,3199.00,3199.00
,"Invoice","09/24/2020","134","Wind/Snow Package","Patty Clark","Wind/Snow Package (Wind/Snow Package)",2,,74.95,149.90,3348.90
,"Invoice","09/24/2020","134","Automatic Pop Vent","Patty Clark","Pop Vent (Automatic Pop Vent)",2,"ea",89.00,178.00,3526.90
,"Invoice","09/24/2020","134","18"" Ground Anchor","Patty Clark","Ground Anchors (18"" Ground Anchor)",6,,30.49,182.94,3709.84
,"Invoice","09/24/2020","134","Z Bracket","Patty Clark","Z Bracket (Z Bracket)",6,,11.23,67.38,3777.22
,"Invoice","09/24/2020","134","26"" Raised Bed","Patty Clark","26""  Raised Bed (26"" Raised Bed)",4,,97.95,391.80,4169.02
,"Invoice","09/24/2020","134","8"" Shelf Bed - 4'","Patty Clark","8"" Shelf Bed -4' (8"" Shelf Bed - 4')",2,,99.95,199.90,4368.92
,"Invoice","09/24/2020","134","Solar Fan Kit 16ï¿½ (solar panel, fan, and thermostat)","Patty Clark","Solar Fan 16ï¿½ (Solar Fan 16ï¿½)",1,"ea",620.20,620.20,4989.12
,"Invoice","09/24/2020","134","Delivery & Install","Patty Clark","Install (Delivery & Install)","",,14.00%,698.48,5687.60
,"Invoice","09/08/2020","132","8' x 16' Greenhouse w/ 4' Pop-out","Patty Winningham","8'x16' Greenhouse w/ 4' Pop-out (8' x 16' Greenhouse w/ 4' Pop-out)",1,,5995.00,5995.00,5995.00
,"Invoice","09/08/2020","132","Additional Door","Patty Winningham","Additional Door (Additional Door)",1,,350.00,350.00,6345.00
,"Invoice","09/08/2020","132","4' Shelf","Patty Winningham","4' Shelf (4' Shelf)",1,,74.95,74.95,6419.95
,"Invoice","09/08/2020","132","26"" Raised Bed","Patty Winningham","26""  Raised Bed (26"" Raised Bed)",2,,97.95,195.90,6615.85
,"Invoice","09/08/2020","132","Automatic Pop Vent","Patty Winningham","Pop Vent (Automatic Pop Vent)",5,"ea",89.00,445.00,7060.85
,"Invoice","09/08/2020","132","Electric Swamp Cooler Large","Patty Winningham","Swamp Cooler Large (Electric Swamp Cooler Large)",1,"ea",600.00,600.00,7660.85
,"Invoice","09/08/2020","132","18"" Ground Anchor","Patty Winningham","Ground Anchors (18"" Ground Anchor)",13,,30.49,396.37,8057.22
,"Invoice","09/08/2020","132","Z Bracket","Patty Winningham","Z Bracket (Z Bracket)",13,,11.23,145.99,8203.21
,"Invoice","09/08/2020","132","Sales Discount 5% - Moana","Patty Winningham","5% Sales Discount (Sales Discount 5%)","",,-5.00%,-410.16,7793.05
,"Invoice","09/08/2020","132","Delivery & Install","Patty Winningham","Install (Delivery & Install)",1,,1096.50,1096.50,8889.55
,"Invoice","03/10/2020","75","8' x 20' Modular Greenhouse","Paul Beagley","8'x20' Modular Greenhouse (8' x 20' Modular Greenhouse)",1,,5249.00,5249.00,5249.00
,"Invoice","03/10/2020","75","Salt Lake City Home Show Discount","Paul Beagley","Discount (Discount)","",,-787.35,-787.35,4461.65
,"Invoice","03/10/2020","75","4"" Concrete","Paul Beagley","Anchors - Concrete (4"" Concrete Tapcons)",24,"ea",2.00,48.00,4509.65
,"Invoice","03/10/2020","75","Automatic Pop Vent","Paul Beagley","Pop Vent (Automatic Pop Vent)",5,"ea",89.00,445.00,4954.65
,"Invoice","03/10/2020","75","4' Shelf","Paul Beagley","4' Shelf (4' Shelf)",9,,74.95,674.55,5629.20
,"Invoice","03/10/2020","75","4' Shelf - Solid Work Bench","Paul Beagley","4'  Shelf  - Solid (4' Shelf - Solid Work Bench)",1,,74.95,74.95,5704.15
,"Invoice","03/10/2020","75"," Swamp Cooler","Paul Beagley","Electric Swamp Cooler Largex ( Swamp Cooler)",1,,600.00,600.00,6304.15
,"Invoice","03/10/2020","75","Custom Trim Package - COMP by Josh","Paul Beagley","Diamond Plate Trim (Custom Trim)",1,"ea",0.00,0.00,6304.15
,"Invoice","03/10/2020","75",,"Paul Beagley","Shipping/Delivery",1,,350.00,350.00,6654.15
,"Invoice","03/10/2020","75","2.9% Fee for credit card transactions","Paul Beagley","Credit Card Fee (2.9% Fee for credit card transactions)","",,2.90%,192.97,6847.12
,"Invoice","07/08/2020","117","Solar Panel, Inverter Kit and Swamp Cooler","Penny Boecks","Swamp Cooler Solar Kit (Solar Panel and Inverter Kit for Swamp Cooler)",1,,1200.00,1200.00,1200.00
,"Invoice","07/08/2020","117","Discount- Credit for existing Solar Fan & Solar Beta Group","Penny Boecks","Discount (Discount)","",,-545.00,-545.00,655.00
,"Invoice","07/08/2020","117","Greenhouse Remove and Replace (125')","Penny Boecks","Install (Delivery & Install)",4,,65.00,260.00,915.00
,"Invoice","08/14/2019","48","8' x 16' Modular Greenhouse","Pine Middle School","8' x 16' Greenhouse (8' x 16' Modular Greenhouse)",1,,4495.00,4495.00,4495.00
,"Invoice","08/14/2019","48","Discount - RootEd","Pine Middle School","Discount (Discount)","",,-1500.00,-1500.00,2995.00
,"Invoice","08/14/2019","48","8' Shelf Bed - 4'","Pine Middle School","8"" Shelf Bed -4' (8"" Shelf Bed - 4')",4,,99.95,399.80,3394.80
,"Invoice","08/14/2019","48","8' Raised Bed - 4'","Pine Middle School","8""  Raised Bed -4' (8""  Raised Bed - 4')",4,,69.95,279.80,3674.60
,"Invoice","08/14/2019","48","26' Raised Bed","Pine Middle School","26""  Raised Bed (26"" Raised Bed)",4,,97.95,391.80,4066.40
,"Invoice","08/14/2019","48","Solar Fan","Pine Middle School","Solar Fan 20"" (Solar Fan)",1,,750.10,750.10,4816.50
,"Invoice","08/14/2019","48","Dual Circuit Thermostat","Pine Middle School","Thermostatx (Dual Circuit Thermostat)",1,,29.95,29.95,4846.45
,"Invoice","08/14/2019","48","16"" Shutter Vent","Pine Middle School","16' Shutter Vent (16"" Shutter Vent)",1,"ea",42.25,42.25,4888.70
,"Invoice","08/14/2019","48","24' Ground Anchor","Pine Middle School","Ground Anchors - 26"" (26"" Ground Anchors)",4,,47.00,188.00,5076.70
,"Invoice","08/14/2019","48","Z Bracket","Pine Middle School","Z Bracket (Z Bracket)",4,,11.23,44.92,5121.62
,"Invoice","08/14/2019","48","Delivery & Install","Pine Middle School","Install (Delivery & Install)",1,,890.00,890.00,6011.62
,"Invoice","08/14/2019","48","Discount - Modular Greenhouse Donates Delivery & Install","Pine Middle School","Discount (Discount)","",,-890.00,-890.00,5121.62
,"Invoice","08/14/2019","48","Self-opening automatic roof vent","Pine Middle School","Automatic Roof Vent (Self-opening automatic roof vent)",4,,65.10,260.40,5382.02
,"Invoice","08/14/2019","48","Univent OT Standard","Pine Middle School","Univent OTStandard (Univent OT Standard)",4,,23.90,95.60,5477.62
,"Invoice","08/14/2019","48","18' Ground Anchor","Pine Middle School","Ground Anchors (18"" Ground Anchor)",14,,30.49,426.86,5904.48
,"Invoice","08/14/2019","48","Z Bracket","Pine Middle School","Z Bracket (Z Bracket)",14,,11.23,157.22,6061.70
,"Invoice","07/12/2019","43","8' x 20' Greenhouse w/ 4' Pop-out","Pinon Hills Elementary School","8'x20' Greenhouse w/ 4' Pop-out (8' x 20' Greenhouse w/ 4' Pop-out)",1,,6749.00,6749.00,6749.00
,"Invoice","07/12/2019","43","Discount  RootEd","Pinon Hills Elementary School","Discount (Discount)","",,-2000.00,-2000.00,4749.00
,"Invoice","07/12/2019","43","18' Ground Anchor","Pinon Hills Elementary School","Ground Anchors (18"" Ground Anchor)",15,,27.88,418.20,5167.20
,"Invoice","07/12/2019","43","Z Bracket","Pinon Hills Elementary School","Z Bracket (Z Bracket)",15,,8.70,130.50,5297.70
,"Invoice","07/12/2019","43","Self-opening automatic roof vent","Pinon Hills Elementary School","Automatic Roof Vent (Self-opening automatic roof vent)",6,,65.10,390.60,5688.30
,"Invoice","07/12/2019","43","Univent OT Standard","Pinon Hills Elementary School","Univent OTStandard (Univent OT Standard)",6,,23.90,143.40,5831.70
,"Invoice","07/12/2019","43","Solar Fan","Pinon Hills Elementary School","Solar Fan 16""x (Solar Fan)",1,,730.10,730.10,6561.80
,"Invoice","07/12/2019","43","Dual Circuit Thermostat","Pinon Hills Elementary School","Thermostatx (Dual Circuit Thermostat)",1,,29.95,29.95,6591.75
,"Invoice","07/12/2019","43","12' Shutter Vent","Pinon Hills Elementary School","12' Shutter Vent (12' Shutter Vent)",1,,29.95,29.95,6621.70
,"Invoice","07/12/2019","43","26' Raised Bed","Pinon Hills Elementary School","26""  Raised Bed (26"" Raised Bed)",5,,97.95,489.75,7111.45
,"Invoice","07/12/2019","43","8' Raised Bed - 4'","Pinon Hills Elementary School","8""  Raised Bed -4' (8""  Raised Bed - 4')",5,,69.95,349.75,7461.20
,"Invoice","07/12/2019","43","8' Shelf Bed - 4'","Pinon Hills Elementary School","8"" Shelf Bed -4' (8"" Shelf Bed - 4')",4,,99.95,399.80,7861.00
,"Invoice","07/12/2019","43","4' Shelf","Pinon Hills Elementary School","4' Shelf (4' Shelf)",1,,74.95,74.95,7935.95
,"Invoice","07/12/2019","43","Delivery & Install 8 x 24","Pinon Hills Elementary School","Install 8 x 24 (Delivery & Install 8 x 24)",1,,500.00,500.00,8435.95
,"Invoice","07/12/2019","43","install Donated by MG","Pinon Hills Elementary School","Discount (Discount)","",,-500.00,-500.00,7935.95
,"Invoice","01/25/2019","2","8' x 16' Modular Greenhouse","Quest House Girls","8' x 16' Greenhouse (8' x 16' Modular Greenhouse)",1,,3965.00,3965.00,3965.00
,"Invoice","01/25/2019","2","Discount -  RootEd","Quest House Girls","Discount (Discount)","",,-1265.00,-1265.00,2700.00
,"Invoice","01/25/2019","2","18' Ground Anchor","Quest House Girls","Ground Anchors (18"" Ground Anchor)",11,,27.88,306.68,3006.68
,"Invoice","01/25/2019","2","Z Bracket","Quest House Girls","Z Bracket (Z Bracket)",11,,8.70,95.70,3102.38
,"Invoice","01/25/2019","2","Self-opening automatic roof vent","Quest House Girls","Automatic Roof Vent (Self-opening automatic roof vent)",6,,65.10,390.60,3492.98
,"Invoice","01/25/2019","2","Univent OT Standard","Quest House Girls","Univent OTStandard (Univent OT Standard)",6,,23.90,143.40,3636.38
,"Invoice","01/25/2019","2","24' Raised Bed","Quest House Girls","26""  Raised Bed (26"" Raised Bed)",4,,97.95,391.80,4028.18
,"Invoice","01/25/2019","2","4' Shelf","Quest House Girls","4' Shelf (4' Shelf)",1,,74.95,74.95,4103.13
,"Invoice","01/25/2019","2","8' Raised Bed - 4'","Quest House Girls","8""  Raised Bed -4' (8""  Raised Bed - 4')",3,,69.95,209.85,4312.98
,"Invoice","01/25/2019","2","8' Shelf Bed - 4'","Quest House Girls","8"" Shelf Bed -4' (8"" Shelf Bed - 4')",3,,99.95,299.85,4612.83
,"Invoice","01/25/2019","2"," Swamp Cooler","Quest House Girls","Electric Swamp Cooler Largex ( Swamp Cooler)",1,,500.00,500.00,5112.83
,"Invoice","01/25/2019","2","Delivery & Install 8 x 16","Quest House Girls","Install 8 x16 (Delivery & Install 8 x 16)",1,,400.00,400.00,5512.83
,"Invoice","01/25/2019","2","Discount - Modular Greenhouses Donates Install","Quest House Girls","Discount (Discount)","",,-400.00,-400.00,5112.83
,"Invoice","05/06/2019","26","8' x 20' Modular Greenhouse","Rail City 1","8'x20' Modular Greenhouse (8' x 20' Modular Greenhouse)",1,,5249.00,5249.00,5249.00
,"Invoice","05/06/2019","26","Discount  Rail City","Rail City 1","Discount (Discount)","",,-262.45,-262.45,4986.55
,"Invoice","05/06/2019","26","Additional Door","Rail City 1","Additional Door (Additional Door)",1,,250.00,250.00,5236.55
,"Invoice","05/06/2019","26","18' Ground Anchor","Rail City 1","Ground Anchors (18"" Ground Anchor)",13,,27.88,362.44,5598.99
,"Invoice","05/06/2019","26","Z Bracket","Rail City 1","Z Bracket (Z Bracket)",13,,8.70,113.10,5712.09
,"Invoice","05/06/2019","26","16' 110v Electric Fan w/ Shutters","Rail City 1","16"" Shutter Fan16A (16"" 110v Electric Fan w/ Shutters)",1,,135.00,135.00,5847.09
,"Invoice","05/06/2019","26","Dual Circuit Thermostat","Rail City 1","Thermostatx (Dual Circuit Thermostat)",1,,29.95,29.95,5877.04
,"Invoice","05/06/2019","26","12' Shutter Vent","Rail City 1","12' Shutter Vent (12' Shutter Vent)",1,,29.95,29.95,5906.99
,"Invoice","05/06/2019","26","26' Raised Bed","Rail City 1","26""  Raised Bed (26"" Raised Bed)",5,,97.95,489.75,6396.74
,"Invoice","05/06/2019","26","8' Raised Bed - 4'","Rail City 1","8""  Raised Bed -4' (8""  Raised Bed - 4')",5,,69.95,349.75,6746.49
,"Invoice","05/06/2019","26","4' Shelf","Rail City 1","4' Shelf (4' Shelf)",3,,74.95,224.85,6971.34
,"Invoice","05/06/2019","26","8' Shelf Bed - 4'","Rail City 1","8"" Shelf Bed -4' (8"" Shelf Bed - 4')",2,,99.95,199.90,7171.24
,"Invoice","05/06/2019","26","Discount","Rail City 1","Discount (Discount)","",,-1075.68,-1075.68,6095.56
,"Invoice","03/11/2020","77","8' x 12' Modular Greenhouse","Rail City 1","8' x 12' Greenhouse (8' x 12' Modular Greenhouse)",1,,3749.00,3749.00,9844.56
,"Invoice","03/11/2020","77","4' Shelf","Rail City 1","4' Shelf (4' Shelf)",3,,74.95,224.85,10069.41
,"Invoice","03/11/2020","77","8"" Shelf Bed - 4'","Rail City 1","8"" Shelf Bed -4' (8"" Shelf Bed - 4')",3,,99.95,299.85,10369.26
,"Invoice","03/11/2020","77","18"" Ground Anchor","Rail City 1","Ground Anchors (18"" Ground Anchor)",9,,30.49,274.41,10643.67
,"Invoice","03/11/2020","77","Z Bracket","Rail City 1","Z Bracket (Z Bracket)",9,,11.23,101.07,10744.74
,"Invoice","03/11/2020","77","Automatic Pop Vent","Rail City 1","Pop Vent (Automatic Pop Vent)",3,"ea",89.00,267.00,11011.74
,"Invoice","03/11/2020","77","Solar Fan","Rail City 1","Solar Fan 16""x (Solar Fan)",1,,620.10,620.10,11631.84
,"Invoice","03/11/2020","77","Dual Circuit Thermostat","Rail City 1","Thermostatx (Dual Circuit Thermostat)",1,,29.95,29.95,11661.79
,"Invoice","03/11/2020","77","Delivery & Install by Rail City","Rail City 1","Install (Delivery & Install)",0,,700.00,0.00,11661.79
,"Invoice","03/11/2020","77","15% Rail City Discount","Rail City 1","15% Dealer Discount (15% Dealer Discount)","",,-15.00%,-834.93,10826.86
,"Invoice","06/19/2020","114","26"" Raised Bed","Rail City 1","26""  Raised Bed (26"" Raised Bed)",3,,97.95,293.85,11120.71
,"Invoice","06/19/2020","114","Side Piece","Rail City 1","Side Piece",4,,15.00,60.00,11180.71
,"Invoice","04/29/2019","24","Falcon Model 4' x 4' x 26"" Raised bed & Cover  - Rail City Sale Price","Rail City 2","Falcon Model (Falcon Model 4' x 4' x 26"" Raised bed & Cover w/ Auto Pop up vent)",2,"ea",799.00,1598.00,1598.00
,"Invoice","04/29/2019","24","Rail City Garden Center's 15%","Rail City 2","Discount (Discount)","",,-239.70,-239.70,1358.30
,"Invoice","06/20/2019","34","Solar Fan","Rail City 3","Solar Fan 16""x (Solar Fan)",1,,620.10,620.10,620.10
,"Invoice","06/20/2019","34","Dual Circuit Thermostat","Rail City 3","Thermostatx (Dual Circuit Thermostat)",1,,29.95,29.95,650.05
,"Invoice","06/20/2019","34","12' Shutter Vent","Rail City 3","12' Shutter Vent (12' Shutter Vent)",1,,29.95,29.95,680.00
,"Invoice","06/20/2019","34","Solar Fan","Rail City 3","Solar Fan 20"" (Solar Fan)",1,,750.10,750.10,1430.10
,"Invoice","06/20/2019","34","Dual Circuit Thermostat","Rail City 3","Thermostatx (Dual Circuit Thermostat)",1,,29.95,29.95,1460.05
,"Invoice","06/20/2019","34","16"" Shutter Vent","Rail City 3","16' Shutter Vent (16"" Shutter Vent)",1,"ea",42.25,42.25,1502.30
,"Invoice","06/20/2019","34","Discount - Rail City 15%","Rail City 3","Discount (Discount)","",,-225.35,-225.35,1276.95
,"Invoice","01/30/2019","4","8' x 20' Greenhouse w/ 4' Pop-out","Reva Crump","8'x20' Greenhouse w/ 4' Pop-out (8' x 20' Greenhouse w/ 4' Pop-out)",1,,5965.00,5965.00,5965.00
,"Invoice","01/30/2019","4","Discount","Reva Crump","Discount (Discount)","",,-869.25,-869.25,5095.75
,"Invoice","01/30/2019","4","18' Ground Anchor","Reva Crump","Ground Anchors (18"" Ground Anchor)",15,,27.88,418.20,5513.95
,"Invoice","01/30/2019","4","Z Bracket","Reva Crump","Z Bracket (Z Bracket)",15,,8.70,130.50,5644.45
,"Invoice","01/30/2019","4","Additional Door","Reva Crump","Additional Door (Additional Door)",1,,350.00,350.00,5994.45
,"Invoice","01/30/2019","4","Self-opening automatic roof vent","Reva Crump","Automatic Roof Vent (Self-opening automatic roof vent)",6,,65.10,390.60,6385.05
,"Invoice","01/30/2019","4","Univent OT Standard","Reva Crump","Univent OTStandard (Univent OT Standard)",6,,23.90,143.40,6528.45
,"Invoice","01/30/2019","4","16' 110v Electric Fan w/ Shutters","Reva Crump","16"" Shutter Fan16A (16"" 110v Electric Fan w/ Shutters)",1,,135.00,135.00,6663.45
,"Invoice","01/30/2019","4","Dual Circuit Thermostat","Reva Crump","Thermostatx (Dual Circuit Thermostat)",1,,29.95,29.95,6693.40
,"Invoice","01/30/2019","4","12' Shutter Vent","Reva Crump","12' Shutter Vent (12' Shutter Vent)",1,,29.95,29.95,6723.35
,"Invoice","01/30/2019","4","24' Raised Bed","Reva Crump","24'  Raised Bed (24' Raised Bed)",2,,97.95,195.90,6919.25
,"Invoice","01/30/2019","4","Delivery & Install 8 x 24","Reva Crump","Install 8 x 24 (Delivery & Install 8 x 24)",1,,500.00,500.00,7419.25
,"Invoice","01/30/2019","4","Discount - free install end of year sale","Reva Crump","Discount (Discount)","",,-500.00,-500.00,6919.25
,"Invoice","01/30/2019","4","Deposit to MG $3726.15 12-27-18","Reva Crump","Discount (Discount)","",,-3726.15,-3726.15,3193.10
,"Invoice","04/28/2020","97","8' x 12' w/ Side Cathedral Modular Greenhouse","Rich Staley","8' x 12' GH Side Cathedral",1,,4495.00,4495.00,4495.00
,"Invoice","04/28/2020","97","Automatic Pop Vent","Rich Staley","Pop Vent (Automatic Pop Vent)",3,"ea",89.00,267.00,4762.00
,"Invoice","04/28/2020","97","Additional Door","Rich Staley","Additional Door (Additional Door)",1,,350.00,350.00,5112.00
,"Invoice","04/28/2020","97","Discount- No Gable End Wall","Rich Staley","Discount (Discount)","",,-700.00,-700.00,4412.00
,"Invoice","04/28/2020","97","Custom wall height-  57"" (standard 60"")","Rich Staley","Custom Build",1,"ea",250.00,250.00,4662.00
,"Invoice","04/28/2020","97","4' Shelf","Rich Staley","4' Shelf (4' Shelf)",2,,74.95,149.90,4811.90
,"Invoice","04/28/2020","97","8""  Raised Bed - 4'","Rich Staley","8""  Raised Bed -4' (8""  Raised Bed - 4')",2,,69.95,139.90,4951.80
,"Invoice","03/19/2019","14","4' x 4' Raised Bed - Reno Home & Garden Show Sale","Richard Hardie","4' x 4'  Raised Bed (4' x 4' Raised Bed)",1,"ea",275.00,275.00,275.00
,"Invoice","03/19/2019","14","Discount","Richard Hardie","Discount (Discount)","",,-46.74,-46.74,228.26
,"Invoice","03/19/2019","14","Raised Bed Delivery","Richard Hardie","Raised Bed Delivery (Raised Bed Delivery)",1,,75.00,75.00,303.26
,"Invoice","03/19/2019","14","Discount","Richard Hardie","Discount (Discount)","",,-75.00,-75.00,228.26
,"Invoice","05/28/2020","111","8' x 12' Modular Greenhouse","Ryan Hansen","8' x 12' Greenhouse (8' x 12' Modular Greenhouse)",1,,3749.00,3749.00,3749.00
,"Invoice","05/28/2020","111","Automatic Pop Vent","Ryan Hansen","Pop Vent (Automatic Pop Vent)",3,"ea",89.00,267.00,4016.00
,"Invoice","05/28/2020","111","Electric Swamp Cooler Large","Ryan Hansen","Swamp Cooler Large (Electric Swamp Cooler Large)",1,"ea",600.00,600.00,4616.00
,"Invoice","05/28/2020","111","26"" Raised Bed","Ryan Hansen","26""  Raised Bed (26"" Raised Bed)",3,,97.95,293.85,4909.85
,"Invoice","05/28/2020","111","18"" Ground Anchor","Ryan Hansen","Ground Anchors (18"" Ground Anchor)",9,,30.49,274.41,5184.26
,"Invoice","05/28/2020","111","Z Bracket","Ryan Hansen","Z Bracket (Z Bracket)",9,,11.23,101.07,5285.33
,"Invoice","05/28/2020","111","Delivery & Install","Ryan Hansen","Install (Delivery & Install)",1,,778.34,778.34,6063.67
,"Invoice","05/28/2020","111","Discount  check for 3500.50 bank deposited as 3500.00 - ka","Ryan Hansen","Discount (Discount)","",,-0.50,-0.50,6063.17
,"Invoice","04/07/2020","99","Sheet Metal - Roof Panel from Metal sales","Sam Duvall","Custom Build",1,"ea",1479.70,1479.70,1479.70
,"Invoice","04/24/2020","89","8' x 8' Modular Greenhouse","Sarah Kopy","8' x 8' Greenhouse (8' x 8' Modular Greenhouse)",1,,3199.00,3199.00,3199.00
,"Invoice","04/24/2020","89","26"" Raised Bed","Sarah Kopy","26""  Raised Bed (26"" Raised Bed)",1,,97.95,97.95,3296.95
,"Invoice","04/24/2020","89","4' Shelf","Sarah Kopy","4' Shelf (4' Shelf)",2,,74.95,149.90,3446.85
,"Invoice","04/24/2020","89","Automatic Pop Vent","Sarah Kopy","Pop Vent (Automatic Pop Vent)",1,"ea",89.00,89.00,3535.85
,"Invoice","04/24/2020","89","18"" Ground Anchor","Sarah Kopy","Ground Anchors (18"" Ground Anchor)",7,,30.49,213.43,3749.28
,"Invoice","04/24/2020","89","Z Bracket","Sarah Kopy","Z Bracket (Z Bracket)",7,,11.23,78.61,3827.89
,"Invoice","04/24/2020","89","Delivery & Install","Sarah Kopy","Install (Delivery & Install)",1,,535.9046,535.90,4363.79
,"Invoice","05/07/2019","27","4' x 6' x 26""Raised Bed","Shain Smith","4' x 6' x 26""   Raised Bed (4' x 6' x 26""Raised Bed)",5,"ea",269.00,1345.00,1345.00
,"Invoice","05/07/2019","27","Discount 10%","Shain Smith","Discount (Discount)","",,-134.69,-134.69,1210.31
,"Invoice","05/07/2019","27","Raised Bed Delivery","Shain Smith","Raised Bed Delivery (Raised Bed Delivery)",1,,75.00,75.00,1285.31
,"Invoice","04/23/2020","88","8' x 12' Modular Greenhouse","Sherri Pueblo","8' x 12' Greenhouse (8' x 12' Modular Greenhouse)",1,,3749.00,3749.00,3749.00
,"Invoice","04/23/2020","88","Discount 10% TV ad (8)","Sherri Pueblo","Discount (Discount)","",,-374.90,-374.90,3374.10
,"Invoice","04/23/2020","88","18' Ground Anchor","Sherri Pueblo","Ground Anchors (18"" Ground Anchor)",9,,30.49,274.41,3648.51
,"Invoice","04/23/2020","88","Z Bracket","Sherri Pueblo","Z Bracket (Z Bracket)",9,,11.23,101.07,3749.58
,"Invoice","04/23/2020","88","8"" Shelf Bed - 4'","Sherri Pueblo","8"" Shelf Bed -4' (8"" Shelf Bed - 4')",2,,99.95,199.90,3949.48
,"Invoice","04/23/2020","88","Self-opening automatic roof vent","Sherri Pueblo","Automatic Roof Vent (Self-opening automatic roof vent)",2,,65.10,130.20,4079.68
,"Invoice","04/23/2020","88","Univent OT Standard","Sherri Pueblo","Univent OTStandard (Univent OT Standard)",2,,23.90,47.80,4127.48
,"Invoice","04/23/2020","88","Ground Fencing","Sherri Pueblo","Ground Fencing (Ground Fencing -under entire GH)",1,"yd",150.00,150.00,4277.48
,"Invoice","07/20/2020","121","8' x 16' Modular Greenhouse","Spencer Phungphiphadhana","8' x 16' Greenhouse (8' x 16' Modular Greenhouse)",1,,4495.00,4495.00,4495.00
,"Invoice","07/20/2020","121","4"" Concrete Tapcons","Spencer Phungphiphadhana","Anchors - Concrete (4"" Concrete Tapcons)",18,"ea",2.00,36.00,4531.00
,"Invoice","07/20/2020","121","Delivery to Site","Spencer Phungphiphadhana","Additional Delivery Fee (Additional $100 for every 25 miles outside Reno/Sparks)",1,,250.00,250.00,4781.00
,"Invoice","07/09/2020","118","8' x 20' Greenhouse w/ 4' Pop-out","Stephen Jaenchen","8'x20' Greenhouse w/ 4' Pop-out (8' x 20' Greenhouse w/ 4' Pop-out)",1,,6749.00,6749.00,6749.00
,"Invoice","07/09/2020","118","13"" Raised Bed","Stephen Jaenchen","13"" Raised Bed",4,,69.95,279.80,7028.80
,"Invoice","07/09/2020","118","8"" Shelf Bed - 4'","Stephen Jaenchen","8"" Shelf Bed -4' (8"" Shelf Bed - 4')",4,,99.95,399.80,7428.60
,"Invoice","07/09/2020","118","26"" Raised Bed","Stephen Jaenchen","26""  Raised Bed (26"" Raised Bed)",5,,97.95,489.75,7918.35
,"Invoice","07/09/2020","118","4' Shelf","Stephen Jaenchen","4' Shelf (4' Shelf)",3,,74.95,224.85,8143.20
,"Invoice","07/09/2020","118","Automatic Pop Vent","Stephen Jaenchen","Pop Vent (Automatic Pop Vent)",6,"ea",89.00,534.00,8677.20
,"Invoice","07/09/2020","118","Electric Swamp Cooler Large","Stephen Jaenchen","Swamp Cooler Large (Electric Swamp Cooler Large)",1,"ea",600.00,600.00,9277.20
,"Invoice","07/09/2020","118","Ground Fencing - Under entire GH","Stephen Jaenchen","Ground Fencing (Ground Fencing -under entire GH)",60,"yd",6.00,360.00,9637.20
,"Invoice","07/09/2020","118","18"" Ground Anchor","Stephen Jaenchen","Ground Anchors (18"" Ground Anchor)",15,,30.49,457.35,10094.55
,"Invoice","07/09/2020","118","Z Bracket","Stephen Jaenchen","Z Bracket (Z Bracket)",15,,11.23,168.45,10263.00
,"Invoice","07/09/2020","118","Sales Discount 10%","Stephen Jaenchen","10% Sales Discount (Sales Discount 10%)","",,-10.00%,-1026.30,9236.70
,"Invoice","07/09/2020","118","Delivery & Install","Stephen Jaenchen","Install (Delivery & Install)",1,,1288.39,1288.39,10525.09
,"Invoice","05/06/2020","107","Automatic Pop Vent","Steve DeVere","Pop Vent (Automatic Pop Vent)",6,"ea",89.00,534.00,534.00
,"Invoice","05/06/2020","107","26"" Raised Bed","Steve DeVere","26""  Raised Bed (26"" Raised Bed)",6,,97.95,587.70,1121.70
,"Invoice","05/06/2020","107","4' Shelf","Steve DeVere","4' Shelf (4' Shelf)",1,,74.95,74.95,1196.65
,"Invoice","05/06/2020","107","Electric Swamp Cooler Large","Steve DeVere","Swamp Cooler Large (Electric Swamp Cooler Large)",1,"ea",600.00,600.00,1796.65
,"Invoice","05/06/2020","107","18"" Ground Anchor","Steve DeVere","Ground Anchors (18"" Ground Anchor)",15,,30.49,457.35,2254.00
,"Invoice","05/06/2020","107","Z Bracket","Steve DeVere","Z Bracket (Z Bracket)",15,,11.23,168.45,2422.45
,"Invoice","05/06/2020","107","Discount 10% per Josh","Steve DeVere","Discount (Discount)","",,-805.617,-805.62,1616.83
,"Invoice","05/06/2020","107","Delivery & Install","Steve DeVere","Install (Delivery & Install)",1,,1015.077,1015.08,2631.91
,"Invoice","05/06/2020","107","8' x 20' Greenhouse w/ 4' Pop-out","Steve DeVere","8'x20' Greenhouse w/ 4' Pop-out (8' x 20' Greenhouse w/ 4' Pop-out)",1,,6749.00,6749.00,9380.91
,"Invoice","05/06/2020","107","8""  Raised Bed - 4'","Steve DeVere","8""  Raised Bed -4' (8""  Raised Bed - 4')",2,,69.95,139.90,9520.81
,"Invoice","05/06/2020","107","8"" Shelf Bed - 4'","Steve DeVere","8"" Shelf Bed -4' (8"" Shelf Bed - 4')",2,,99.95,199.90,9720.71
,"Invoice","05/06/2020","107","4' x 2' Work Bench","Steve DeVere","4' Work Bench (4' x 2' Work Bench)",1,"ea",74.95,74.95,9795.66
,"Invoice","03/20/2019","17","Falcon Model 4' x 4' x 26"" Raised bed & Cover w/ Auto Pop up vent","Steven Applewhite","Falcon Model (Falcon Model 4' x 4' x 26"" Raised bed & Cover w/ Auto Pop up vent)",1,"ea",999.00,999.00,999.00
,"Invoice","03/20/2019","17","Discount","Steven Applewhite","Discount (Discount)","",,-100.00,-100.00,899.00
,"Invoice","03/20/2019","17","add on  4' x 8' section","Steven Applewhite","Custom Build Accessories",1,,650.00,650.00,1549.00
,"Invoice","03/20/2019","17","Discount","Steven Applewhite","Discount (Discount)","",,-65.00,-65.00,1484.00
,"Invoice","03/20/2019","17","Back Wall","Steven Applewhite","Custom Build Accessories",1,,650.00,650.00,2134.00
,"Invoice","03/20/2019","17","Discount","Steven Applewhite","Discount (Discount)","",,-65.00,-65.00,2069.00
,"Invoice","03/20/2019","17","Self-opening automatic roof vent","Steven Applewhite","Automatic Roof Vent (Self-opening automatic roof vent)",1,,65.10,65.10,2134.10
,"Invoice","03/20/2019","17","Univent OT Standard","Steven Applewhite","Univent OTStandard (Univent OT Standard)",1,,23.90,23.90,2158.00
,"Invoice","03/20/2019","17","Delivery & Install 8 x 4","Steven Applewhite","Install 8 x 4 (Delivery & Install 8 x 4)",1,,250.00,250.00,2408.00
,"Invoice","03/20/2019","17","Discount","Steven Applewhite","Discount (Discount)","",,-50.00,-50.00,2358.00
,"Invoice","02/21/2020","68","8' x 12' Modular Greenhouse","Sue & Jim Pinney","8' x 12' Greenhouse (8' x 12' Modular Greenhouse)",1,,3749.00,3749.00,3749.00
,"Invoice","02/21/2020","68","Special Discount 10% - (Approved by Josh)","Sue & Jim Pinney","Discount (Discount)","",,-374.90,-374.90,3374.10
,"Invoice","02/21/2020","68","Automatic Pop Vent","Sue & Jim Pinney","Pop Vent (Automatic Pop Vent)",3,"ea",89.00,267.00,3641.10
,"Invoice","02/21/2020","68","26"" Raised Bed","Sue & Jim Pinney","26""  Raised Bed (26"" Raised Bed)",3,,97.95,293.85,3934.95
,"Invoice","02/21/2020","68","12"" 110v Electric Fan w/ Shutters","Sue & Jim Pinney","12"" Shutter Fan12A (12"" 110v Electric Fan w/ Shutters)",1,,197.05,197.05,4132.00
,"Invoice","02/21/2020","68","4"" Concrete Tapcons","Sue & Jim Pinney","Anchors - Concrete (4"" Concrete Tapcons)",20,"ea",2.00,40.00,4172.00
,"Invoice","02/21/2020","68","18"" Ground Anchor","Sue & Jim Pinney","Ground Anchors (18"" Ground Anchor)",6,,30.49,182.94,4354.94
,"Invoice","02/21/2020","68","Z Bracket","Sue & Jim Pinney","Z Bracket (Z Bracket)",6,,11.23,67.38,4422.32
,"Invoice","02/21/2020","68","Delivery & Install","Sue & Jim Pinney","Install (Delivery & Install)",1,,602.00,602.00,5024.32
,"Invoice","02/21/2020","68","Additional $100 for every 25 miles outside Reno/Sparks","Sue & Jim Pinney","Additional Delivery Fee (Additional $100 for every 25 miles outside Reno/Sparks)",2,,100.00,200.00,5224.32
,"Invoice","02/21/2020","68",,"Sue & Jim Pinney","Comp (JS)",1,,-200.00,-200.00,5024.32
,"Invoice","02/21/2020","68","*** ADD 8"" TO THE LOWER WALL SECTIONS FOR TOTAL HEIGHT OF 68""  ****","Sue & Jim Pinney","Custom Build",1,"ea",450.00,450.00,5474.32
,"Invoice","02/21/2020","68",,"Sue & Jim Pinney","Comp (JS)",1,,-450.00,-450.00,5024.32
,"Invoice","05/14/2020","104","Electric Swamp Cooler Large","Sue & Jim Pinney","Swamp Cooler Large (Electric Swamp Cooler Large)",1,"ea",600.00,600.00,5624.32
,"Invoice","05/14/2020","104","Delivery & Install","Sue & Jim Pinney","Install (Delivery & Install)",1,,89.964,89.96,5714.28
,"Invoice","05/14/2020","104","Discount- Difference for solar fan that was not installed.","Sue & Jim Pinney","Discount (Discount)","",,-200.00,-200.00,5514.28
,"Invoice","08/30/2019","50","26""  Raised Bed (23"" x 47"")","Susan Cesarini","26""  Raised Bed (26"" Raised Bed)",2,,97.95,195.90,195.90
,"Invoice","08/30/2019","50","8"" Shelf Bed - 4' (23"" x 47"")","Susan Cesarini","8"" Shelf Bed -4' (8"" Shelf Bed - 4')",2,,99.95,199.90,395.80
,"Invoice","08/30/2019","50","8""  Raised Bed - (23"" x 44"")","Susan Cesarini","8""  Raised Bed -4' (8""  Raised Bed - 4')",2,,69.95,139.90,535.70
,"Invoice","08/30/2019","50","4'  Shelf    (32"" x 48"")","Susan Cesarini","4' Shelf (4' Shelf)",1,,74.95,74.95,610.65
,"Invoice","08/30/2019","50","Shelf above 15"" x 48""","Susan Cesarini","Custom Build Accessories",1,,74.95,74.95,685.60
,"Invoice","08/30/2019","50"," Swamp Cooler","Susan Cesarini","Electric Swamp Cooler Largex ( Swamp Cooler)",1,,420.90,420.90,1106.50
,"Invoice","08/30/2019","50","Self-opening automatic roof vent","Susan Cesarini","Automatic Roof Vent (Self-opening automatic roof vent)",2,,65.10,130.20,1236.70
,"Invoice","08/30/2019","50","Univent OT Standard","Susan Cesarini","Univent OTStandard (Univent OT Standard)",2,,23.90,47.80,1284.50
,"Invoice","08/30/2019","50","Delivery & Install","Susan Cesarini","Accessory Install (Delivery & Install)",1,,170.00,170.00,1454.50
,"Invoice","04/24/2020","91","8' x 20' Greenhouse w/ 4' Pop-out","Susan Johnston","8'x20' Greenhouse w/ 4' Pop-out (8' x 20' Greenhouse w/ 4' Pop-out)",1,,6749.00,6749.00,6749.00
,"Invoice","04/24/2020","91","Discount","Susan Johnston","Discount (Discount)","",,-674.90,-674.90,6074.10
,"Invoice","04/24/2020","91","18"" Ground Anchor","Susan Johnston","Ground Anchors (18"" Ground Anchor)",15,,30.49,457.35,6531.45
,"Invoice","04/24/2020","91","Z Bracket","Susan Johnston","Z Bracket (Z Bracket)",15,,11.23,168.45,6699.90
,"Invoice","04/24/2020","91","Automatic Pop Vent","Susan Johnston","Pop Vent (Automatic Pop Vent)",8,"ea",89.00,712.00,7411.90
,"Invoice","04/24/2020","91","18"" 110v Electric Fan w/ Shutters","Susan Johnston","18"" Shutter Fan18A (18"" 110v Electric Fan w/ Shutters)",1,,139.23,139.23,7551.13
,"Invoice","04/24/2020","91","Dual Circuit Thermostat","Susan Johnston","Thermostatx (Dual Circuit Thermostat)",1,,29.95,29.95,7581.08
,"Invoice","04/24/2020","91","12' Shutter Vent","Susan Johnston","12' Shutter Vent (12' Shutter Vent)",1,,29.95,29.95,7611.03
,"Invoice","08/11/2020","124","4' Shelf","Susan Johnston","4' Shelf (4' Shelf)",10,,74.95,749.50,8360.53
,"Invoice","08/11/2020","124","Delivery & Install","Susan Johnston","Install (Delivery & Install)",1,,104.93,104.93,8465.46
,"Invoice","05/13/2020","103","8' x 4' Addition to current GH","Susan Mcgowan","8' x 4'   Addition (8' x 4' Addition to current GH)",2,,700.00,1400.00,1400.00
,"Invoice","05/13/2020","103","Automatic Pop Vent","Susan Mcgowan","Pop Vent (Automatic Pop Vent)",2,"ea",89.00,178.00,1578.00
,"Invoice","05/13/2020","103","18"" Ground Anchor","Susan Mcgowan","Ground Anchors (18"" Ground Anchor)",2,,30.49,60.98,1638.98
,"Invoice","05/13/2020","103","Z Bracket","Susan Mcgowan","Z Bracket (Z Bracket)",2,,11.23,22.46,1661.44
,"Invoice","05/13/2020","103","Delivery & Install","Susan Mcgowan","Install (Delivery & Install)",1,,250.00,250.00,1911.44
,"Invoice","05/13/2020","103","Discount per Josh","Susan Mcgowan","Discount (Discount)","",,-410.00,-410.00,1501.44
,"Invoice","03/18/2019","15","4' x 4' Raised Bed","Tami Weber","4' x 4'  Raised Bed (4' x 4' Raised Bed)",1,"ea",329.00,329.00,329.00
,"Invoice","03/18/2019","15","4' x 8' x 26"" Raised Bed w/Cover","Tami Weber","4' x 8' x 26"" Raised Bed (4' x 8' x 26"" Raised Bed w/Cover)",1,"ea",1699.00,1699.00,2028.00
,"Invoice","03/18/2019","15","Discount Reno Home Show","Tami Weber","Discount (Discount)","",,-400.00,-400.00,1628.00
,"Invoice","03/18/2019","15","Raided Bed Delivery","Tami Weber","Raised Bed Delivery (Raised Bed Delivery)",1,,75.00,75.00,1703.00
,"Invoice","03/18/2019","15","Discount Delivery","Tami Weber","Discount (Discount)","",,-75.00,-75.00,1628.00
,"Credit Memo","05/27/2019",,"to adjust for under-payment","Tami Weber","Square fee adjustment",-1,,0.18,-0.18,1627.82
,"Invoice","01/03/2020","59","8' x 12' Modular Greenhouse","Thomas Burke","8' x 12' Greenhouse (8' x 12' Modular Greenhouse)",1,,3749.00,3749.00,3749.00
,"Invoice","01/03/2020","59","Discount End of the  year 10%","Thomas Burke","Discount (Discount)","",,-374.90,-374.90,3374.10
,"Invoice","01/03/2020","59","18' Ground Anchor","Thomas Burke","Ground Anchors (18"" Ground Anchor)",9,,30.49,274.41,3648.51
,"Invoice","01/03/2020","59","Z Bracket","Thomas Burke","Z Bracket (Z Bracket)",9,,11.23,101.07,3749.58
,"Invoice","01/03/2020","59","Self-opening automatic roof vent","Thomas Burke","Automatic Roof Vent (Self-opening automatic roof vent)",4,,65.10,260.40,4009.98
,"Invoice","01/03/2020","59","Univent OT Standard","Thomas Burke","Univent OTStandard (Univent OT Standard)",4,,23.90,95.60,4105.58
,"Invoice","01/03/2020","59","Delivery & Install","Thomas Burke","Install (Delivery & Install)",1,,670.06,670.06,4775.64
,"Invoice","01/03/2020","59","Additional $100 for every 25 miles outside Reno/Sparks","Thomas Burke","Additional Delivery Fee (Additional $100 for every 25 miles outside Reno/Sparks)",1,,100.00,100.00,4875.64
,"Invoice","01/03/2020","59","10' 110v electric fan w/ shutters","Thomas Burke","10"" Shutter Fan (10"" 110v electric fan w/ shutters)",1,,150.05,150.05,5025.69
,"Invoice","01/03/2020","59","Dual Circuit Thermostat","Thomas Burke","Thermostatx (Dual Circuit Thermostat)",1,,29.95,29.95,5055.64
,"Invoice","04/27/2020","92","8' x 12' Modular Greenhouse","Timothy Schlichter","8' x 12' Greenhouse (8' x 12' Modular Greenhouse)",1,,3749.00,3749.00,3749.00
,"Invoice","04/27/2020","92","Automatic Pop Vent","Timothy Schlichter","Pop Vent (Automatic Pop Vent)",4,"ea",89.00,356.00,4105.00
,"Invoice","04/27/2020","92","26"" Raised Bed","Timothy Schlichter","26""  Raised Bed (26"" Raised Bed)",3,,97.95,293.85,4398.85
,"Invoice","04/27/2020","92","8"" Shelf Bed - 4'","Timothy Schlichter","8"" Shelf Bed -4' (8"" Shelf Bed - 4')",3,,99.95,299.85,4698.70
,"Invoice","04/27/2020","92","8""  Raised Bed - 4'","Timothy Schlichter","8""  Raised Bed -4' (8""  Raised Bed - 4')",3,,69.95,209.85,4908.55
,"Invoice","04/27/2020","92"," Swamp Cooler","Timothy Schlichter","Electric Swamp Cooler small ( Swamp Cooler)",1,,400.00,400.00,5308.55
,"Invoice","04/27/2020","92","Solar Panel and Inverter Kit for Swamp Cooler","Timothy Schlichter","Swamp Cooler Solar Kit (Solar Panel and Inverter Kit for Swamp Cooler)",1,,700.00,700.00,6008.55
,"Invoice","04/27/2020","92","18"" Ground Anchor","Timothy Schlichter","Ground Anchors (18"" Ground Anchor)",9,,30.49,274.41,6282.96
,"Invoice","04/27/2020","92","Z Bracket","Timothy Schlichter","Z Bracket (Z Bracket)",9,,11.23,101.07,6384.03
,"Invoice","02/06/2019","7","8' x 24' Modular Greenhouse","Valarie Heriloom Gardens","8'x24' Modular Greenhouse (8' x 24' Modular Greenhouse)",1,,5495.00,5495.00,5495.00
,"Invoice","02/06/2019","7","Discount","Valarie Heriloom Gardens","Discount (Discount)","",,-824.25,-824.25,4670.75
,"Invoice","02/06/2019","7","18' Ground Anchor","Valarie Heriloom Gardens","Ground Anchors (18"" Ground Anchor)",15,,27.88,418.20,5088.95
,"Invoice","02/06/2019","7","Z Bracket","Valarie Heriloom Gardens","Z Bracket (Z Bracket)",15,,8.70,130.50,5219.45
,"Invoice","02/06/2019","7","Self-opening automatic roof vent","Valarie Heriloom Gardens","Automatic Roof Vent (Self-opening automatic roof vent)",4,,65.10,260.40,5479.85
,"Invoice","02/06/2019","7","Univent OT Standard","Valarie Heriloom Gardens","Univent OTStandard (Univent OT Standard)",4,,23.90,95.60,5575.45
,"Invoice","02/06/2019","7","18' 110v Electric Fan w/ Shutters","Valarie Heriloom Gardens","18"" Shutter Fan18A (18"" 110v Electric Fan w/ Shutters)",1,,139.23,139.23,5714.68
,"Invoice","02/06/2019","7","Dual Circuit Thermostat","Valarie Heriloom Gardens","Thermostatx (Dual Circuit Thermostat)",1,,29.95,29.95,5744.63
,"Invoice","02/06/2019","7","12' Shutter Vent","Valarie Heriloom Gardens","12' Shutter Vent (12' Shutter Vent)",1,,29.95,29.95,5774.58
,"Invoice","02/06/2019","7","Custom 4' x 3' Shelf (Down South side of GH)","Valarie Heriloom Gardens","Custom Build Accessories",6,,125.00,750.00,6524.58
,"Invoice","02/06/2019","7","Delivery & Install 8 x 24","Valarie Heriloom Gardens","Install 8 x 24 (Delivery & Install 8 x 24)",1,,500.00,500.00,7024.58
,"Invoice","03/11/2019",,"to adjust for over-payment","Valarie Heriloom Gardens","Square fee adjustment",1,,0.23,0.23,7024.81

